,image_Height,image_Width,image_Format,image_mode,image_Animated,image_Frames,image_id,class,Xmin,Xmax,Ymin,Ymax,width,height
0,2560,2560,JPEG,RGB,False,1,78400c58-1a7c-4342-a1fb-2117cb7cbc8b.jpg,Airplane,209,354,55,234,145,179
1,2560,2560,JPEG,RGB,False,1,78400c58-1a7c-4342-a1fb-2117cb7cbc8b.jpg,Airplane,1660,1841,72,266,181,194
2,2560,2560,JPEG,RGB,False,1,78400c58-1a7c-4342-a1fb-2117cb7cbc8b.jpg,Airplane,2185,2280,71,159,95,88
3,2560,2560,JPEG,RGB,False,1,78400c58-1a7c-4342-a1fb-2117cb7cbc8b.jpg,Airplane,2397,2522,171,274,125,103
4,2560,2560,JPEG,RGB,False,1,78400c58-1a7c-4342-a1fb-2117cb7cbc8b.jpg,Airplane,2309,2491,300,459,182,159
5,2560,2560,JPEG,RGB,False,1,78400c58-1a7c-4342-a1fb-2117cb7cbc8b.jpg,Truncated_airplane,2495,2567,405,552,72,147
6,2560,2560,JPEG,RGB,False,1,78400c58-1a7c-4342-a1fb-2117cb7cbc8b.jpg,Airplane,1777,1927,284,437,150,153
7,2560,2560,JPEG,RGB,False,1,78400c58-1a7c-4342-a1fb-2117cb7cbc8b.jpg,Airplane,1946,2100,449,611,154,162
8,2560,2560,JPEG,RGB,False,1,78400c58-1a7c-4342-a1fb-2117cb7cbc8b.jpg,Airplane,1853,2031,629,779,178,150
9,2560,2560,JPEG,RGB,False,1,78400c58-1a7c-4342-a1fb-2117cb7cbc8b.jpg,Airplane,2121,2292,759,924,171,165
10,2560,2560,JPEG,RGB,False,1,78400c58-1a7c-4342-a1fb-2117cb7cbc8b.jpg,Airplane,1828,1933,806,889,105,83
11,2560,2560,JPEG,RGB,False,1,78400c58-1a7c-4342-a1fb-2117cb7cbc8b.jpg,Airplane,1247,1418,215,424,171,209
12,2560,2560,JPEG,RGB,False,1,78400c58-1a7c-4342-a1fb-2117cb7cbc8b.jpg,Airplane,1040,1211,313,498,171,185
13,2560,2560,JPEG,RGB,False,1,78400c58-1a7c-4342-a1fb-2117cb7cbc8b.jpg,Airplane,803,1012,389,592,209,203
14,2560,2560,JPEG,RGB,False,1,78400c58-1a7c-4342-a1fb-2117cb7cbc8b.jpg,Airplane,622,798,475,658,176,183
15,2560,2560,JPEG,RGB,False,1,78400c58-1a7c-4342-a1fb-2117cb7cbc8b.jpg,Airplane,1159,1265,793,915,106,122
16,2560,2560,JPEG,RGB,False,1,78400c58-1a7c-4342-a1fb-2117cb7cbc8b.jpg,Airplane,1664,1752,980,1089,88,109
17,2560,2560,JPEG,RGB,False,1,78400c58-1a7c-4342-a1fb-2117cb7cbc8b.jpg,Airplane,1541,1644,1010,1129,103,119
18,2560,2560,JPEG,RGB,False,1,78400c58-1a7c-4342-a1fb-2117cb7cbc8b.jpg,Airplane,1178,1268,1174,1274,90,100
19,2560,2560,JPEG,RGB,False,1,78400c58-1a7c-4342-a1fb-2117cb7cbc8b.jpg,Airplane,1857,2031,1442,1643,174,201
20,2560,2560,JPEG,RGB,False,1,78400c58-1a7c-4342-a1fb-2117cb7cbc8b.jpg,Airplane,805,1006,2103,2281,201,178
21,2560,2560,JPEG,RGB,False,1,78400c58-1a7c-4342-a1fb-2117cb7cbc8b.jpg,Airplane,671,776,1919,2034,105,115
22,2560,2560,JPEG,RGB,False,1,78400c58-1a7c-4342-a1fb-2117cb7cbc8b.jpg,Airplane,289,387,2072,2169,98,97
23,2560,2560,JPEG,RGB,False,1,78400c58-1a7c-4342-a1fb-2117cb7cbc8b.jpg,Airplane,0,104,1912,2009,104,97
24,2560,2560,JPEG,RGB,False,1,f82d64a6-3bfa-4612-bcbd-847a7d89c296.jpg,Airplane,1379,1470,429,531,91,102
25,2560,2560,JPEG,RGB,False,1,f82d64a6-3bfa-4612-bcbd-847a7d89c296.jpg,Airplane,1627,1707,248,345,80,97
26,2560,2560,JPEG,RGB,False,1,f82d64a6-3bfa-4612-bcbd-847a7d89c296.jpg,Airplane,1707,1836,128,262,129,134
27,2560,2560,JPEG,RGB,False,1,f82d64a6-3bfa-4612-bcbd-847a7d89c296.jpg,Airplane,1860,1948,65,163,88,98
28,2560,2560,JPEG,RGB,False,1,f82d64a6-3bfa-4612-bcbd-847a7d89c296.jpg,Airplane,1782,1913,626,763,131,137
29,2560,2560,JPEG,RGB,False,1,f82d64a6-3bfa-4612-bcbd-847a7d89c296.jpg,Airplane,1546,1690,944,1072,144,128
30,2560,2560,JPEG,RGB,False,1,f82d64a6-3bfa-4612-bcbd-847a7d89c296.jpg,Airplane,1506,1646,1106,1250,140,144
31,2560,2560,JPEG,RGB,False,1,f82d64a6-3bfa-4612-bcbd-847a7d89c296.jpg,Airplane,1495,1673,1291,1444,178,153
32,2560,2560,JPEG,RGB,False,1,f82d64a6-3bfa-4612-bcbd-847a7d89c296.jpg,Airplane,860,1034,1191,1324,174,133
33,2560,2560,JPEG,RGB,False,1,f82d64a6-3bfa-4612-bcbd-847a7d89c296.jpg,Airplane,715,814,923,1019,99,96
34,2560,2560,JPEG,RGB,False,1,f82d64a6-3bfa-4612-bcbd-847a7d89c296.jpg,Airplane,513,635,780,931,122,151
35,2560,2560,JPEG,RGB,False,1,f82d64a6-3bfa-4612-bcbd-847a7d89c296.jpg,Airplane,244,328,1538,1653,84,115
36,2560,2560,JPEG,RGB,False,1,f82d64a6-3bfa-4612-bcbd-847a7d89c296.jpg,Airplane,513,651,1416,1557,138,141
37,2560,2560,JPEG,RGB,False,1,f82d64a6-3bfa-4612-bcbd-847a7d89c296.jpg,Airplane,914,1071,1367,1524,157,157
38,2560,2560,JPEG,RGB,False,1,f82d64a6-3bfa-4612-bcbd-847a7d89c296.jpg,Airplane,929,1112,1557,1724,183,167
39,2560,2560,JPEG,RGB,False,1,f82d64a6-3bfa-4612-bcbd-847a7d89c296.jpg,Airplane,946,1107,1745,1887,161,142
40,2560,2560,JPEG,RGB,False,1,f82d64a6-3bfa-4612-bcbd-847a7d89c296.jpg,Airplane,994,1133,1906,2024,139,118
41,2560,2560,JPEG,RGB,False,1,f82d64a6-3bfa-4612-bcbd-847a7d89c296.jpg,Airplane,1011,1169,2212,2359,158,147
42,2560,2560,JPEG,RGB,False,1,f82d64a6-3bfa-4612-bcbd-847a7d89c296.jpg,Airplane,582,730,1990,2138,148,148
43,2560,2560,JPEG,RGB,False,1,f82d64a6-3bfa-4612-bcbd-847a7d89c296.jpg,Airplane,1550,1722,1669,1856,172,187
44,2560,2560,JPEG,RGB,False,1,f82d64a6-3bfa-4612-bcbd-847a7d89c296.jpg,Airplane,1514,1682,1496,1643,168,147
45,2560,2560,JPEG,RGB,False,1,f82d64a6-3bfa-4612-bcbd-847a7d89c296.jpg,Airplane,1952,2111,1550,1682,159,132
46,2560,2560,JPEG,RGB,False,1,f82d64a6-3bfa-4612-bcbd-847a7d89c296.jpg,Airplane,1642,1742,1951,2044,100,93
47,2560,2560,JPEG,RGB,False,1,f82d64a6-3bfa-4612-bcbd-847a7d89c296.jpg,Airplane,1666,1781,2190,2286,115,96
48,2560,2560,JPEG,RGB,False,1,f82d64a6-3bfa-4612-bcbd-847a7d89c296.jpg,Airplane,2025,2189,2169,2322,164,153
49,2560,2560,JPEG,RGB,False,1,c98a544c-4206-4176-b480-35b8bdf5bb14.jpg,Airplane,248,381,191,319,133,128
50,2560,2560,JPEG,RGB,False,1,c98a544c-4206-4176-b480-35b8bdf5bb14.jpg,Airplane,1080,1239,467,597,159,130
51,2560,2560,JPEG,RGB,False,1,c98a544c-4206-4176-b480-35b8bdf5bb14.jpg,Airplane,2238,2360,361,465,122,104
52,2560,2560,JPEG,RGB,False,1,c98a544c-4206-4176-b480-35b8bdf5bb14.jpg,Airplane,1250,1301,740,783,51,43
53,2560,2560,JPEG,RGB,False,1,c98a544c-4206-4176-b480-35b8bdf5bb14.jpg,Airplane,1195,1241,687,746,46,59
54,2560,2560,JPEG,RGB,False,1,c98a544c-4206-4176-b480-35b8bdf5bb14.jpg,Airplane,1127,1181,662,721,54,59
55,2560,2560,JPEG,RGB,False,1,c98a544c-4206-4176-b480-35b8bdf5bb14.jpg,Airplane,791,848,527,573,57,46
56,2560,2560,JPEG,RGB,False,1,c98a544c-4206-4176-b480-35b8bdf5bb14.jpg,Airplane,695,739,568,628,44,60
57,2560,2560,JPEG,RGB,False,1,c98a544c-4206-4176-b480-35b8bdf5bb14.jpg,Airplane,754,809,614,662,55,48
58,2560,2560,JPEG,RGB,False,1,c98a544c-4206-4176-b480-35b8bdf5bb14.jpg,Airplane,547,675,497,635,128,138
59,2560,2560,JPEG,RGB,False,1,c98a544c-4206-4176-b480-35b8bdf5bb14.jpg,Airplane,463,545,548,661,82,113
60,2560,2560,JPEG,RGB,False,1,c98a544c-4206-4176-b480-35b8bdf5bb14.jpg,Airplane,405,491,645,715,86,70
61,2560,2560,JPEG,RGB,False,1,c98a544c-4206-4176-b480-35b8bdf5bb14.jpg,Airplane,103,227,421,561,124,140
62,2560,2560,JPEG,RGB,False,1,c98a544c-4206-4176-b480-35b8bdf5bb14.jpg,Airplane,866,952,962,1061,86,99
63,2560,2560,JPEG,RGB,False,1,c98a544c-4206-4176-b480-35b8bdf5bb14.jpg,Airplane,764,841,907,1006,77,99
64,2560,2560,JPEG,RGB,False,1,c98a544c-4206-4176-b480-35b8bdf5bb14.jpg,Airplane,662,741,855,949,79,94
65,2560,2560,JPEG,RGB,False,1,c98a544c-4206-4176-b480-35b8bdf5bb14.jpg,Airplane,530,644,795,920,114,125
66,2560,2560,JPEG,RGB,False,1,c98a544c-4206-4176-b480-35b8bdf5bb14.jpg,Airplane,61,180,815,940,119,125
67,2560,2560,JPEG,RGB,False,1,c98a544c-4206-4176-b480-35b8bdf5bb14.jpg,Airplane,893,966,1313,1388,73,75
68,2560,2560,JPEG,RGB,False,1,c98a544c-4206-4176-b480-35b8bdf5bb14.jpg,Airplane,834,905,1380,1463,71,83
69,2560,2560,JPEG,RGB,False,1,c98a544c-4206-4176-b480-35b8bdf5bb14.jpg,Airplane,772,842,1453,1529,70,76
70,2560,2560,JPEG,RGB,False,1,c98a544c-4206-4176-b480-35b8bdf5bb14.jpg,Airplane,615,737,1403,1534,122,131
71,2560,2560,JPEG,RGB,False,1,c98a544c-4206-4176-b480-35b8bdf5bb14.jpg,Airplane,476,596,1318,1477,120,159
72,2560,2560,JPEG,RGB,False,1,c98a544c-4206-4176-b480-35b8bdf5bb14.jpg,Airplane,344,466,1242,1401,122,159
73,2560,2560,JPEG,RGB,False,1,c98a544c-4206-4176-b480-35b8bdf5bb14.jpg,Airplane,208,330,1183,1328,122,145
74,2560,2560,JPEG,RGB,False,1,c98a544c-4206-4176-b480-35b8bdf5bb14.jpg,Airplane,71,185,1121,1263,114,142
75,2560,2560,JPEG,RGB,False,1,c98a544c-4206-4176-b480-35b8bdf5bb14.jpg,Airplane,49,173,1423,1577,124,154
76,2560,2560,JPEG,RGB,False,1,c98a544c-4206-4176-b480-35b8bdf5bb14.jpg,Truncated_airplane,0,54,1030,1168,54,138
77,2560,2560,JPEG,RGB,False,1,c98a544c-4206-4176-b480-35b8bdf5bb14.jpg,Airplane,1661,1739,1367,1440,78,73
78,2560,2560,JPEG,RGB,False,1,c98a544c-4206-4176-b480-35b8bdf5bb14.jpg,Airplane,1670,1759,1277,1343,89,66
79,2560,2560,JPEG,RGB,False,1,c98a544c-4206-4176-b480-35b8bdf5bb14.jpg,Airplane,1704,1795,1185,1257,91,72
80,2560,2560,JPEG,RGB,False,1,c98a544c-4206-4176-b480-35b8bdf5bb14.jpg,Airplane,1763,1853,1096,1164,90,68
81,2560,2560,JPEG,RGB,False,1,c98a544c-4206-4176-b480-35b8bdf5bb14.jpg,Airplane,1672,1748,947,1026,76,79
82,2560,2560,JPEG,RGB,False,1,c98a544c-4206-4176-b480-35b8bdf5bb14.jpg,Airplane,1564,1642,893,1011,78,118
83,2560,2560,JPEG,RGB,False,1,c98a544c-4206-4176-b480-35b8bdf5bb14.jpg,Airplane,1511,1584,978,1072,73,94
84,2560,2560,JPEG,RGB,False,1,c98a544c-4206-4176-b480-35b8bdf5bb14.jpg,Airplane,1493,1569,1071,1140,76,69
85,2560,2560,JPEG,RGB,False,1,c98a544c-4206-4176-b480-35b8bdf5bb14.jpg,Airplane,1445,1520,1168,1266,75,98
86,2560,2560,JPEG,RGB,False,1,c98a544c-4206-4176-b480-35b8bdf5bb14.jpg,Airplane,1348,1417,1150,1240,69,90
87,2560,2560,JPEG,RGB,False,1,c98a544c-4206-4176-b480-35b8bdf5bb14.jpg,Airplane,1264,1334,1112,1195,70,83
88,2560,2560,JPEG,RGB,False,1,c98a544c-4206-4176-b480-35b8bdf5bb14.jpg,Airplane,2481,2554,1500,1575,73,75
89,2560,2560,JPEG,RGB,False,1,c98a544c-4206-4176-b480-35b8bdf5bb14.jpg,Airplane,2300,2395,1410,1476,95,66
90,2560,2560,JPEG,RGB,False,1,c98a544c-4206-4176-b480-35b8bdf5bb14.jpg,Airplane,2257,2370,1290,1385,113,95
91,2560,2560,JPEG,RGB,False,1,c98a544c-4206-4176-b480-35b8bdf5bb14.jpg,Airplane,2101,2174,1200,1297,73,97
92,2560,2560,JPEG,RGB,False,1,c98a544c-4206-4176-b480-35b8bdf5bb14.jpg,Airplane,2024,2107,1282,1370,83,88
93,2560,2560,JPEG,RGB,False,1,c98a544c-4206-4176-b480-35b8bdf5bb14.jpg,Airplane,2278,2348,1746,1833,70,87
94,2560,2560,JPEG,RGB,False,1,c98a544c-4206-4176-b480-35b8bdf5bb14.jpg,Airplane,2191,2246,1729,1814,55,85
95,2560,2560,JPEG,RGB,False,1,c98a544c-4206-4176-b480-35b8bdf5bb14.jpg,Airplane,1935,2006,1718,1791,71,73
96,2560,2560,JPEG,RGB,False,1,c98a544c-4206-4176-b480-35b8bdf5bb14.jpg,Airplane,1909,1996,1952,2044,87,92
97,2560,2560,JPEG,RGB,False,1,c98a544c-4206-4176-b480-35b8bdf5bb14.jpg,Airplane,2115,2207,2376,2474,92,98
98,2560,2560,JPEG,RGB,False,1,c98a544c-4206-4176-b480-35b8bdf5bb14.jpg,Airplane,1927,1977,2257,2333,50,76
99,2560,2560,JPEG,RGB,False,1,c98a544c-4206-4176-b480-35b8bdf5bb14.jpg,Airplane,1821,1891,2180,2279,70,99
100,2560,2560,JPEG,RGB,False,1,c98a544c-4206-4176-b480-35b8bdf5bb14.jpg,Airplane,1717,1791,2122,2231,74,109
101,2560,2560,JPEG,RGB,False,1,c98a544c-4206-4176-b480-35b8bdf5bb14.jpg,Airplane,855,1020,2449,2552,165,103
102,2560,2560,JPEG,RGB,False,1,4c9d2482-788c-4d68-a3d4-478b2367abce.jpg,Airplane,1677,1777,485,554,100,69
103,2560,2560,JPEG,RGB,False,1,4c9d2482-788c-4d68-a3d4-478b2367abce.jpg,Airplane,1904,1996,853,923,92,70
104,2560,2560,JPEG,RGB,False,1,4c9d2482-788c-4d68-a3d4-478b2367abce.jpg,Airplane,2163,2248,866,934,85,68
105,2560,2560,JPEG,RGB,False,1,4c9d2482-788c-4d68-a3d4-478b2367abce.jpg,Airplane,2384,2474,938,1005,90,67
106,2560,2560,JPEG,RGB,False,1,4c9d2482-788c-4d68-a3d4-478b2367abce.jpg,Airplane,2386,2473,1185,1253,87,68
107,2560,2560,JPEG,RGB,False,1,4c9d2482-788c-4d68-a3d4-478b2367abce.jpg,Airplane,2394,2475,1348,1411,81,63
108,2560,2560,JPEG,RGB,False,1,4c9d2482-788c-4d68-a3d4-478b2367abce.jpg,Airplane,2154,2235,1364,1429,81,65
109,2560,2560,JPEG,RGB,False,1,4c9d2482-788c-4d68-a3d4-478b2367abce.jpg,Airplane,2150,2242,1657,1730,92,73
110,2560,2560,JPEG,RGB,False,1,4c9d2482-788c-4d68-a3d4-478b2367abce.jpg,Airplane,2153,2243,1744,1815,90,71
111,2560,2560,JPEG,RGB,False,1,4c9d2482-788c-4d68-a3d4-478b2367abce.jpg,Airplane,2165,2248,1828,1902,83,74
112,2560,2560,JPEG,RGB,False,1,4c9d2482-788c-4d68-a3d4-478b2367abce.jpg,Airplane,2155,2248,1911,1985,93,74
113,2560,2560,JPEG,RGB,False,1,4c9d2482-788c-4d68-a3d4-478b2367abce.jpg,Airplane,2138,2225,1993,2070,87,77
114,2560,2560,JPEG,RGB,False,1,4c9d2482-788c-4d68-a3d4-478b2367abce.jpg,Airplane,2162,2264,2169,2245,102,76
115,2560,2560,JPEG,RGB,False,1,4c9d2482-788c-4d68-a3d4-478b2367abce.jpg,Airplane,2179,2280,2255,2317,101,62
116,2560,2560,JPEG,RGB,False,1,4c9d2482-788c-4d68-a3d4-478b2367abce.jpg,Airplane,2381,2474,1904,1988,93,84
117,2560,2560,JPEG,RGB,False,1,4c9d2482-788c-4d68-a3d4-478b2367abce.jpg,Airplane,1528,1638,847,923,110,76
118,2560,2560,JPEG,RGB,False,1,4c9d2482-788c-4d68-a3d4-478b2367abce.jpg,Airplane,1769,1856,939,1003,87,64
119,2560,2560,JPEG,RGB,False,1,4c9d2482-788c-4d68-a3d4-478b2367abce.jpg,Airplane,1771,1869,1023,1102,98,79
120,2560,2560,JPEG,RGB,False,1,4c9d2482-788c-4d68-a3d4-478b2367abce.jpg,Airplane,1527,1633,1017,1084,106,67
121,2560,2560,JPEG,RGB,False,1,4c9d2482-788c-4d68-a3d4-478b2367abce.jpg,Airplane,1526,1630,1105,1178,104,73
122,2560,2560,JPEG,RGB,False,1,4c9d2482-788c-4d68-a3d4-478b2367abce.jpg,Airplane,1528,1634,1295,1365,106,70
123,2560,2560,JPEG,RGB,False,1,4c9d2482-788c-4d68-a3d4-478b2367abce.jpg,Airplane,1535,1617,1385,1459,82,74
124,2560,2560,JPEG,RGB,False,1,4c9d2482-788c-4d68-a3d4-478b2367abce.jpg,Airplane,1788,1860,1476,1547,72,71
125,2560,2560,JPEG,RGB,False,1,4c9d2482-788c-4d68-a3d4-478b2367abce.jpg,Airplane,1776,1862,1606,1683,86,77
126,2560,2560,JPEG,RGB,False,1,4c9d2482-788c-4d68-a3d4-478b2367abce.jpg,Airplane,1762,1854,1793,1866,92,73
127,2560,2560,JPEG,RGB,False,1,4c9d2482-788c-4d68-a3d4-478b2367abce.jpg,Airplane,1743,1847,1885,1954,104,69
128,2560,2560,JPEG,RGB,False,1,4c9d2482-788c-4d68-a3d4-478b2367abce.jpg,Airplane,1768,1867,2074,2143,99,69
129,2560,2560,JPEG,RGB,False,1,4c9d2482-788c-4d68-a3d4-478b2367abce.jpg,Airplane,1772,1854,2255,2318,82,63
130,2560,2560,JPEG,RGB,False,1,4c9d2482-788c-4d68-a3d4-478b2367abce.jpg,Airplane,1512,1611,1469,1544,99,75
131,2560,2560,JPEG,RGB,False,1,4c9d2482-788c-4d68-a3d4-478b2367abce.jpg,Airplane,1536,1641,1888,1960,105,72
132,2560,2560,JPEG,RGB,False,1,4c9d2482-788c-4d68-a3d4-478b2367abce.jpg,Airplane,1535,1642,2071,2140,107,69
133,2560,2560,JPEG,RGB,False,1,4c9d2482-788c-4d68-a3d4-478b2367abce.jpg,Airplane,1525,1672,2159,2237,147,78
134,2560,2560,JPEG,RGB,False,1,4c9d2482-788c-4d68-a3d4-478b2367abce.jpg,Airplane,1155,1244,847,918,89,71
135,2560,2560,JPEG,RGB,False,1,4c9d2482-788c-4d68-a3d4-478b2367abce.jpg,Airplane,1138,1240,1011,1087,102,76
136,2560,2560,JPEG,RGB,False,1,4c9d2482-788c-4d68-a3d4-478b2367abce.jpg,Airplane,1147,1260,1303,1382,113,79
137,2560,2560,JPEG,RGB,False,1,4c9d2482-788c-4d68-a3d4-478b2367abce.jpg,Airplane,1147,1255,1565,1647,108,82
138,2560,2560,JPEG,RGB,False,1,4c9d2482-788c-4d68-a3d4-478b2367abce.jpg,Airplane,1151,1256,1864,1949,105,85
139,2560,2560,JPEG,RGB,False,1,4c9d2482-788c-4d68-a3d4-478b2367abce.jpg,Airplane,1165,1254,2049,2131,89,82
140,2560,2560,JPEG,RGB,False,1,4c9d2482-788c-4d68-a3d4-478b2367abce.jpg,Airplane,1159,1256,2144,2219,97,75
141,2560,2560,JPEG,RGB,False,1,4c9d2482-788c-4d68-a3d4-478b2367abce.jpg,Airplane,915,1038,2233,2326,123,93
142,2560,2560,JPEG,RGB,False,1,4c9d2482-788c-4d68-a3d4-478b2367abce.jpg,Airplane,786,878,2082,2188,92,106
143,2560,2560,JPEG,RGB,False,1,4c9d2482-788c-4d68-a3d4-478b2367abce.jpg,Airplane,543,637,2059,2127,94,68
144,2560,2560,JPEG,RGB,False,1,4c9d2482-788c-4d68-a3d4-478b2367abce.jpg,Airplane,698,747,1952,2007,49,55
145,2560,2560,JPEG,RGB,False,1,4c9d2482-788c-4d68-a3d4-478b2367abce.jpg,Airplane,932,1047,1696,1776,115,80
146,2560,2560,JPEG,RGB,False,1,4c9d2482-788c-4d68-a3d4-478b2367abce.jpg,Airplane,929,1052,1804,1899,123,95
147,2560,2560,JPEG,RGB,False,1,4c9d2482-788c-4d68-a3d4-478b2367abce.jpg,Airplane,539,635,1785,1860,96,75
148,2560,2560,JPEG,RGB,False,1,4c9d2482-788c-4d68-a3d4-478b2367abce.jpg,Airplane,538,637,1598,1669,99,71
149,2560,2560,JPEG,RGB,False,1,4c9d2482-788c-4d68-a3d4-478b2367abce.jpg,Airplane,567,635,1456,1508,68,52
150,2560,2560,JPEG,RGB,False,1,4c9d2482-788c-4d68-a3d4-478b2367abce.jpg,Airplane,562,635,1196,1270,73,74
151,2560,2560,JPEG,RGB,False,1,4c9d2482-788c-4d68-a3d4-478b2367abce.jpg,Airplane,684,745,971,1049,61,78
152,2560,2560,JPEG,RGB,False,1,4c9d2482-788c-4d68-a3d4-478b2367abce.jpg,Airplane,547,614,924,983,67,59
153,2560,2560,JPEG,RGB,False,1,4c9d2482-788c-4d68-a3d4-478b2367abce.jpg,Airplane,932,1035,876,950,103,74
154,2560,2560,JPEG,RGB,False,1,4c9d2482-788c-4d68-a3d4-478b2367abce.jpg,Airplane,932,1039,1338,1403,107,65
155,2560,2560,JPEG,RGB,False,1,4c9d2482-788c-4d68-a3d4-478b2367abce.jpg,Airplane,920,1021,1426,1511,101,85
156,2560,2560,JPEG,RGB,False,1,b3c7c22d-9c71-4ff3-9146-e2f9ab2f9787.jpg,Airplane,1517,1660,130,267,143,137
157,2560,2560,JPEG,RGB,False,1,b3c7c22d-9c71-4ff3-9146-e2f9ab2f9787.jpg,Airplane,1491,1568,496,585,77,89
158,2560,2560,JPEG,RGB,False,1,b3c7c22d-9c71-4ff3-9146-e2f9ab2f9787.jpg,Airplane,1390,1469,531,625,79,94
159,2560,2560,JPEG,RGB,False,1,b3c7c22d-9c71-4ff3-9146-e2f9ab2f9787.jpg,Airplane,1907,2037,668,838,130,170
160,2560,2560,JPEG,RGB,False,1,b3c7c22d-9c71-4ff3-9146-e2f9ab2f9787.jpg,Airplane,1710,1892,664,847,182,183
161,2560,2560,JPEG,RGB,False,1,b3c7c22d-9c71-4ff3-9146-e2f9ab2f9787.jpg,Airplane,1264,1431,975,1146,167,171
162,2560,2560,JPEG,RGB,False,1,b3c7c22d-9c71-4ff3-9146-e2f9ab2f9787.jpg,Airplane,1336,1499,1155,1291,163,136
163,2560,2560,JPEG,RGB,False,1,b3c7c22d-9c71-4ff3-9146-e2f9ab2f9787.jpg,Airplane,1388,1506,1332,1435,118,103
164,2560,2560,JPEG,RGB,False,1,b3c7c22d-9c71-4ff3-9146-e2f9ab2f9787.jpg,Airplane,1033,1128,1279,1357,95,78
165,2560,2560,JPEG,RGB,False,1,b3c7c22d-9c71-4ff3-9146-e2f9ab2f9787.jpg,Airplane,2276,2333,225,308,57,83
166,2560,2560,JPEG,RGB,False,1,b3c7c22d-9c71-4ff3-9146-e2f9ab2f9787.jpg,Truncated_airplane,2235,2384,1147,1320,149,173
167,2560,2560,JPEG,RGB,False,1,b3c7c22d-9c71-4ff3-9146-e2f9ab2f9787.jpg,Airplane,1646,1734,1682,1791,88,109
168,2560,2560,JPEG,RGB,False,1,b3c7c22d-9c71-4ff3-9146-e2f9ab2f9787.jpg,Airplane,1832,2001,1889,2037,169,148
169,2560,2560,JPEG,RGB,False,1,b3c7c22d-9c71-4ff3-9146-e2f9ab2f9787.jpg,Airplane,1890,1975,2317,2390,85,73
170,2560,2560,JPEG,RGB,False,1,b3c7c22d-9c71-4ff3-9146-e2f9ab2f9787.jpg,Airplane,1475,1558,2052,2125,83,73
171,2560,2560,JPEG,RGB,False,1,b3c7c22d-9c71-4ff3-9146-e2f9ab2f9787.jpg,Airplane,1478,1560,2261,2324,82,63
172,2560,2560,JPEG,RGB,False,1,b3c7c22d-9c71-4ff3-9146-e2f9ab2f9787.jpg,Airplane,1499,1565,2390,2453,66,63
173,2560,2560,JPEG,RGB,False,1,b3c7c22d-9c71-4ff3-9146-e2f9ab2f9787.jpg,Airplane,1134,1262,1726,1842,128,116
174,2560,2560,JPEG,RGB,False,1,b3c7c22d-9c71-4ff3-9146-e2f9ab2f9787.jpg,Airplane,1273,1342,2356,2414,69,58
175,2560,2560,JPEG,RGB,False,1,b3c7c22d-9c71-4ff3-9146-e2f9ab2f9787.jpg,Airplane,1246,1331,2223,2280,85,57
176,2560,2560,JPEG,RGB,False,1,b3c7c22d-9c71-4ff3-9146-e2f9ab2f9787.jpg,Airplane,1233,1307,2149,2203,74,54
177,2560,2560,JPEG,RGB,False,1,b3c7c22d-9c71-4ff3-9146-e2f9ab2f9787.jpg,Airplane,608,754,1818,1957,146,139
178,2560,2560,JPEG,RGB,False,1,b3c7c22d-9c71-4ff3-9146-e2f9ab2f9787.jpg,Airplane,209,321,1021,1118,112,97
179,2560,2560,JPEG,RGB,False,1,b3c7c22d-9c71-4ff3-9146-e2f9ab2f9787.jpg,Airplane,211,292,1314,1397,81,83
180,2560,2560,JPEG,RGB,False,1,b3c7c22d-9c71-4ff3-9146-e2f9ab2f9787.jpg,Airplane,241,377,1578,1699,136,121
181,2560,2560,JPEG,RGB,False,1,b3c7c22d-9c71-4ff3-9146-e2f9ab2f9787.jpg,Airplane,229,377,1732,1872,148,140
182,2560,2560,JPEG,RGB,False,1,b3c7c22d-9c71-4ff3-9146-e2f9ab2f9787.jpg,Airplane,90,199,1638,1740,109,102
183,2560,2560,JPEG,RGB,False,1,b3c7c22d-9c71-4ff3-9146-e2f9ab2f9787.jpg,Airplane,196,328,2160,2285,132,125
184,2560,2560,JPEG,RGB,False,1,b3c7c22d-9c71-4ff3-9146-e2f9ab2f9787.jpg,Truncated_airplane,0,35,1019,1077,35,58
185,2560,2560,JPEG,RGB,False,1,90c365f8-18b6-4230-be74-cd856a1ba98f.jpg,Airplane,2103,2186,625,734,83,109
186,2560,2560,JPEG,RGB,False,1,90c365f8-18b6-4230-be74-cd856a1ba98f.jpg,Airplane,2407,2478,391,502,71,111
187,2560,2560,JPEG,RGB,False,1,90c365f8-18b6-4230-be74-cd856a1ba98f.jpg,Airplane,2010,2080,215,278,70,63
188,2560,2560,JPEG,RGB,False,1,90c365f8-18b6-4230-be74-cd856a1ba98f.jpg,Airplane,1916,1978,162,215,62,53
189,2560,2560,JPEG,RGB,False,1,90c365f8-18b6-4230-be74-cd856a1ba98f.jpg,Airplane,1834,1902,105,177,68,72
190,2560,2560,JPEG,RGB,False,1,90c365f8-18b6-4230-be74-cd856a1ba98f.jpg,Airplane,2003,2047,480,541,44,61
191,2560,2560,JPEG,RGB,False,1,90c365f8-18b6-4230-be74-cd856a1ba98f.jpg,Airplane,2071,2129,426,498,58,72
192,2560,2560,JPEG,RGB,False,1,90c365f8-18b6-4230-be74-cd856a1ba98f.jpg,Airplane,2115,2184,345,410,69,65
193,2560,2560,JPEG,RGB,False,1,90c365f8-18b6-4230-be74-cd856a1ba98f.jpg,Airplane,1716,1813,333,451,97,118
194,2560,2560,JPEG,RGB,False,1,90c365f8-18b6-4230-be74-cd856a1ba98f.jpg,Airplane,1926,1969,460,533,43,73
195,2560,2560,JPEG,RGB,False,1,90c365f8-18b6-4230-be74-cd856a1ba98f.jpg,Airplane,880,1019,668,778,139,110
196,2560,2560,JPEG,RGB,False,1,90c365f8-18b6-4230-be74-cd856a1ba98f.jpg,Airplane,791,949,794,926,158,132
197,2560,2560,JPEG,RGB,False,1,90c365f8-18b6-4230-be74-cd856a1ba98f.jpg,Airplane,717,878,932,1048,161,116
198,2560,2560,JPEG,RGB,False,1,90c365f8-18b6-4230-be74-cd856a1ba98f.jpg,Airplane,2259,2332,2240,2339,73,99
199,2560,2560,JPEG,RGB,False,1,90c365f8-18b6-4230-be74-cd856a1ba98f.jpg,Airplane,1897,2000,2350,2451,103,101
200,2560,2560,JPEG,RGB,False,1,90c365f8-18b6-4230-be74-cd856a1ba98f.jpg,Airplane,391,468,1116,1179,77,63
201,2560,2560,JPEG,RGB,False,1,90c365f8-18b6-4230-be74-cd856a1ba98f.jpg,Airplane,482,564,1178,1256,82,78
202,2560,2560,JPEG,RGB,False,1,90c365f8-18b6-4230-be74-cd856a1ba98f.jpg,Airplane,652,807,1084,1206,155,122
203,2560,2560,JPEG,RGB,False,1,90c365f8-18b6-4230-be74-cd856a1ba98f.jpg,Airplane,455,606,794,921,151,127
204,2560,2560,JPEG,RGB,False,1,90c365f8-18b6-4230-be74-cd856a1ba98f.jpg,Airplane,571,658,700,766,87,66
205,2560,2560,JPEG,RGB,False,1,90c365f8-18b6-4230-be74-cd856a1ba98f.jpg,Airplane,627,699,576,642,72,66
206,2560,2560,JPEG,RGB,False,1,90c365f8-18b6-4230-be74-cd856a1ba98f.jpg,Airplane,154,306,669,798,152,129
207,2560,2560,JPEG,RGB,False,1,1e7e0450-6eb3-479e-88c2-990abc8207fa.jpg,Airplane,1598,1689,873,938,91,65
208,2560,2560,JPEG,RGB,False,1,1e7e0450-6eb3-479e-88c2-990abc8207fa.jpg,Airplane,1433,1505,941,998,72,57
209,2560,2560,JPEG,RGB,False,1,1e7e0450-6eb3-479e-88c2-990abc8207fa.jpg,Airplane,1110,1195,1070,1129,85,59
210,2560,2560,JPEG,RGB,False,1,1e7e0450-6eb3-479e-88c2-990abc8207fa.jpg,Airplane,867,972,1168,1227,105,59
211,2560,2560,JPEG,RGB,False,1,1e7e0450-6eb3-479e-88c2-990abc8207fa.jpg,Airplane,723,803,1226,1283,80,57
212,2560,2560,JPEG,RGB,False,1,1e7e0450-6eb3-479e-88c2-990abc8207fa.jpg,Airplane,635,694,1310,1373,59,63
213,2560,2560,JPEG,RGB,False,1,1e7e0450-6eb3-479e-88c2-990abc8207fa.jpg,Airplane,750,823,1645,1733,73,88
214,2560,2560,JPEG,RGB,False,1,1e7e0450-6eb3-479e-88c2-990abc8207fa.jpg,Airplane,1041,1090,1605,1656,49,51
215,2560,2560,JPEG,RGB,False,1,1e7e0450-6eb3-479e-88c2-990abc8207fa.jpg,Airplane,1440,1500,1434,1489,60,55
216,2560,2560,JPEG,RGB,False,1,1e7e0450-6eb3-479e-88c2-990abc8207fa.jpg,Airplane,1944,2022,1302,1353,78,51
217,2560,2560,JPEG,RGB,False,1,1e7e0450-6eb3-479e-88c2-990abc8207fa.jpg,Airplane,1972,2058,1372,1422,86,50
218,2560,2560,JPEG,RGB,False,1,1e7e0450-6eb3-479e-88c2-990abc8207fa.jpg,Airplane,2221,2287,1305,1360,66,55
219,2560,2560,JPEG,RGB,False,1,1e7e0450-6eb3-479e-88c2-990abc8207fa.jpg,Airplane,2247,2323,1379,1430,76,51
220,2560,2560,JPEG,RGB,False,1,1e7e0450-6eb3-479e-88c2-990abc8207fa.jpg,Airplane,2034,2114,1513,1564,80,51
221,2560,2560,JPEG,RGB,False,1,1e7e0450-6eb3-479e-88c2-990abc8207fa.jpg,Airplane,1923,1985,1634,1695,62,61
222,2560,2560,JPEG,RGB,False,1,1e7e0450-6eb3-479e-88c2-990abc8207fa.jpg,Airplane,1851,1905,1650,1707,54,57
223,2560,2560,JPEG,RGB,False,1,1e7e0450-6eb3-479e-88c2-990abc8207fa.jpg,Airplane,1789,1831,1691,1757,42,66
224,2560,2560,JPEG,RGB,False,1,1e7e0450-6eb3-479e-88c2-990abc8207fa.jpg,Airplane,1747,1805,1762,1812,58,50
225,2560,2560,JPEG,RGB,False,1,1e7e0450-6eb3-479e-88c2-990abc8207fa.jpg,Airplane,1648,1716,1749,1796,68,47
226,2560,2560,JPEG,RGB,False,1,1e7e0450-6eb3-479e-88c2-990abc8207fa.jpg,Airplane,1613,1684,1819,1875,71,56
227,2560,2560,JPEG,RGB,False,1,1e7e0450-6eb3-479e-88c2-990abc8207fa.jpg,Airplane,1515,1574,1797,1850,59,53
228,2560,2560,JPEG,RGB,False,1,1e7e0450-6eb3-479e-88c2-990abc8207fa.jpg,Airplane,1469,1534,1876,1929,65,53
229,2560,2560,JPEG,RGB,False,1,1e7e0450-6eb3-479e-88c2-990abc8207fa.jpg,Airplane,1667,1739,481,546,72,65
230,2560,2560,JPEG,RGB,False,1,1e7e0450-6eb3-479e-88c2-990abc8207fa.jpg,Airplane,1887,1936,711,781,49,70
231,2560,2560,JPEG,RGB,False,1,1e7e0450-6eb3-479e-88c2-990abc8207fa.jpg,Airplane,1247,1324,1019,1077,77,58
232,2560,2560,JPEG,RGB,False,1,1e7e0450-6eb3-479e-88c2-990abc8207fa.jpg,Airplane,1206,1259,1979,2044,53,65
233,2560,2560,JPEG,RGB,False,1,1e7e0450-6eb3-479e-88c2-990abc8207fa.jpg,Airplane,1666,1742,481,543,76,62
234,2560,2560,JPEG,RGB,False,1,1e7e0450-6eb3-479e-88c2-990abc8207fa.jpg,Airplane,1878,1937,714,783,59,69
235,2560,2560,JPEG,RGB,False,1,1e7e0450-6eb3-479e-88c2-990abc8207fa.jpg,Airplane,1606,1678,872,931,72,59
236,2560,2560,JPEG,RGB,False,1,1e7e0450-6eb3-479e-88c2-990abc8207fa.jpg,Airplane,1437,1508,938,998,71,60
237,2560,2560,JPEG,RGB,False,1,1e7e0450-6eb3-479e-88c2-990abc8207fa.jpg,Airplane,1249,1315,1016,1075,66,59
238,2560,2560,JPEG,RGB,False,1,1e7e0450-6eb3-479e-88c2-990abc8207fa.jpg,Airplane,1107,1185,1072,1131,78,59
239,2560,2560,JPEG,RGB,False,1,1e7e0450-6eb3-479e-88c2-990abc8207fa.jpg,Airplane,889,963,1157,1218,74,61
240,2560,2560,JPEG,RGB,False,1,1e7e0450-6eb3-479e-88c2-990abc8207fa.jpg,Airplane,721,793,1228,1286,72,58
241,2560,2560,JPEG,RGB,False,1,1e7e0450-6eb3-479e-88c2-990abc8207fa.jpg,Airplane,639,700,1311,1381,61,70
242,2560,2560,JPEG,RGB,False,1,1e7e0450-6eb3-479e-88c2-990abc8207fa.jpg,Airplane,760,846,1650,1746,86,96
243,2560,2560,JPEG,RGB,False,1,1e7e0450-6eb3-479e-88c2-990abc8207fa.jpg,Airplane,1041,1087,1600,1665,46,65
244,2560,2560,JPEG,RGB,False,1,1e7e0450-6eb3-479e-88c2-990abc8207fa.jpg,Airplane,1200,1258,1979,2037,58,58
245,2560,2560,JPEG,RGB,False,1,1e7e0450-6eb3-479e-88c2-990abc8207fa.jpg,Airplane,1472,1533,1870,1928,61,58
246,2560,2560,JPEG,RGB,False,1,1e7e0450-6eb3-479e-88c2-990abc8207fa.jpg,Airplane,1512,1570,1795,1863,58,68
247,2560,2560,JPEG,RGB,False,1,1e7e0450-6eb3-479e-88c2-990abc8207fa.jpg,Airplane,1611,1670,1814,1873,59,59
248,2560,2560,JPEG,RGB,False,1,1e7e0450-6eb3-479e-88c2-990abc8207fa.jpg,Airplane,1648,1707,1740,1803,59,63
249,2560,2560,JPEG,RGB,False,1,1e7e0450-6eb3-479e-88c2-990abc8207fa.jpg,Airplane,1746,1807,1760,1818,61,58
250,2560,2560,JPEG,RGB,False,1,1e7e0450-6eb3-479e-88c2-990abc8207fa.jpg,Airplane,1785,1841,1686,1754,56,68
251,2560,2560,JPEG,RGB,False,1,1e7e0450-6eb3-479e-88c2-990abc8207fa.jpg,Airplane,1849,1907,1642,1712,58,70
252,2560,2560,JPEG,RGB,False,1,1e7e0450-6eb3-479e-88c2-990abc8207fa.jpg,Airplane,1920,1978,1631,1702,58,71
253,2560,2560,JPEG,RGB,False,1,1e7e0450-6eb3-479e-88c2-990abc8207fa.jpg,Airplane,2032,2103,1510,1569,71,59
254,2560,2560,JPEG,RGB,False,1,1e7e0450-6eb3-479e-88c2-990abc8207fa.jpg,Airplane,1977,2047,1372,1428,70,56
255,2560,2560,JPEG,RGB,False,1,1e7e0450-6eb3-479e-88c2-990abc8207fa.jpg,Airplane,1947,2020,1303,1361,73,58
256,2560,2560,JPEG,RGB,False,1,1e7e0450-6eb3-479e-88c2-990abc8207fa.jpg,Airplane,2224,2289,1305,1361,65,56
257,2560,2560,JPEG,RGB,False,1,1e7e0450-6eb3-479e-88c2-990abc8207fa.jpg,Airplane,2250,2316,1377,1433,66,56
258,2560,2560,JPEG,RGB,False,1,1e7e0450-6eb3-479e-88c2-990abc8207fa.jpg,Airplane,1439,1494,1433,1500,55,67
259,2560,2560,JPEG,RGB,False,1,54442e49-5271-42bf-a8fb-a2cab30cfd49.jpg,Airplane,1300,1391,367,466,91,99
260,2560,2560,JPEG,RGB,False,1,54442e49-5271-42bf-a8fb-a2cab30cfd49.jpg,Airplane,1290,1382,485,584,92,99
261,2560,2560,JPEG,RGB,False,1,54442e49-5271-42bf-a8fb-a2cab30cfd49.jpg,Airplane,1296,1391,618,717,95,99
262,2560,2560,JPEG,RGB,False,1,54442e49-5271-42bf-a8fb-a2cab30cfd49.jpg,Airplane,1298,1392,753,852,94,99
263,2560,2560,JPEG,RGB,False,1,54442e49-5271-42bf-a8fb-a2cab30cfd49.jpg,Airplane,1293,1384,870,965,91,95
264,2560,2560,JPEG,RGB,False,1,54442e49-5271-42bf-a8fb-a2cab30cfd49.jpg,Airplane,1483,1607,1007,1162,124,155
265,2560,2560,JPEG,RGB,False,1,54442e49-5271-42bf-a8fb-a2cab30cfd49.jpg,Airplane,1225,1377,1147,1276,152,129
266,2560,2560,JPEG,RGB,False,1,54442e49-5271-42bf-a8fb-a2cab30cfd49.jpg,Airplane,1289,1379,1303,1399,90,96
267,2560,2560,JPEG,RGB,False,1,54442e49-5271-42bf-a8fb-a2cab30cfd49.jpg,Airplane,1346,1453,1415,1513,107,98
268,2560,2560,JPEG,RGB,False,1,54442e49-5271-42bf-a8fb-a2cab30cfd49.jpg,Airplane,1225,1403,1546,1714,178,168
269,2560,2560,JPEG,RGB,False,1,54442e49-5271-42bf-a8fb-a2cab30cfd49.jpg,Airplane,768,863,1785,1876,95,91
270,2560,2560,JPEG,RGB,False,1,54442e49-5271-42bf-a8fb-a2cab30cfd49.jpg,Airplane,1163,1260,1779,1884,97,105
271,2560,2560,JPEG,RGB,False,1,54442e49-5271-42bf-a8fb-a2cab30cfd49.jpg,Airplane,1305,1400,1785,1906,95,121
272,2560,2560,JPEG,RGB,False,1,54442e49-5271-42bf-a8fb-a2cab30cfd49.jpg,Airplane,974,1095,1930,2030,121,100
273,2560,2560,JPEG,RGB,False,1,54442e49-5271-42bf-a8fb-a2cab30cfd49.jpg,Airplane,1103,1197,2078,2181,94,103
274,2560,2560,JPEG,RGB,False,1,54442e49-5271-42bf-a8fb-a2cab30cfd49.jpg,Airplane,1219,1313,2062,2155,94,93
275,2560,2560,JPEG,RGB,False,1,54442e49-5271-42bf-a8fb-a2cab30cfd49.jpg,Airplane,727,822,2091,2182,95,91
276,2560,2560,JPEG,RGB,False,1,54442e49-5271-42bf-a8fb-a2cab30cfd49.jpg,Airplane,1153,1257,2337,2435,104,98
277,2560,2560,JPEG,RGB,False,1,54442e49-5271-42bf-a8fb-a2cab30cfd49.jpg,Airplane,1894,2084,1975,2155,190,180
278,2560,2560,JPEG,RGB,False,1,54442e49-5271-42bf-a8fb-a2cab30cfd49.jpg,Airplane,1906,2064,1784,1946,158,162
279,2560,2560,JPEG,RGB,False,1,54442e49-5271-42bf-a8fb-a2cab30cfd49.jpg,Airplane,2321,2426,2021,2118,105,97
280,2560,2560,JPEG,RGB,False,1,54442e49-5271-42bf-a8fb-a2cab30cfd49.jpg,Airplane,2294,2476,1787,1954,182,167
281,2560,2560,JPEG,RGB,False,1,54442e49-5271-42bf-a8fb-a2cab30cfd49.jpg,Airplane,2301,2498,1582,1757,197,175
282,2560,2560,JPEG,RGB,False,1,54442e49-5271-42bf-a8fb-a2cab30cfd49.jpg,Airplane,1896,2067,1580,1754,171,174
283,2560,2560,JPEG,RGB,False,1,54442e49-5271-42bf-a8fb-a2cab30cfd49.jpg,Airplane,2297,2499,1363,1542,202,179
284,2560,2560,JPEG,RGB,False,1,54442e49-5271-42bf-a8fb-a2cab30cfd49.jpg,Airplane,1882,2069,1178,1357,187,179
285,2560,2560,JPEG,RGB,False,1,54442e49-5271-42bf-a8fb-a2cab30cfd49.jpg,Airplane,2294,2453,1129,1296,159,167
286,2560,2560,JPEG,RGB,False,1,54442e49-5271-42bf-a8fb-a2cab30cfd49.jpg,Airplane,2298,2473,892,1059,175,167
287,2560,2560,JPEG,RGB,False,1,54442e49-5271-42bf-a8fb-a2cab30cfd49.jpg,Airplane,1883,2070,977,1155,187,178
288,2560,2560,JPEG,RGB,False,1,54442e49-5271-42bf-a8fb-a2cab30cfd49.jpg,Airplane,1880,2069,776,955,189,179
289,2560,2560,JPEG,RGB,False,1,54442e49-5271-42bf-a8fb-a2cab30cfd49.jpg,Airplane,2281,2470,599,776,189,177
290,2560,2560,JPEG,RGB,False,1,54442e49-5271-42bf-a8fb-a2cab30cfd49.jpg,Airplane,2305,2497,334,511,192,177
291,2560,2560,JPEG,RGB,False,1,54442e49-5271-42bf-a8fb-a2cab30cfd49.jpg,Airplane,1938,2039,423,517,101,94
292,2560,2560,JPEG,RGB,False,1,54442e49-5271-42bf-a8fb-a2cab30cfd49.jpg,Airplane,1669,1834,518,693,165,175
293,2560,2560,JPEG,RGB,False,1,54442e49-5271-42bf-a8fb-a2cab30cfd49.jpg,Airplane,1940,2034,102,194,94,92
294,2560,2560,JPEG,RGB,False,1,54442e49-5271-42bf-a8fb-a2cab30cfd49.jpg,Airplane,595,690,294,400,95,106
295,2560,2560,JPEG,RGB,False,1,54442e49-5271-42bf-a8fb-a2cab30cfd49.jpg,Airplane,709,805,296,391,96,95
296,2560,2560,JPEG,RGB,False,1,54442e49-5271-42bf-a8fb-a2cab30cfd49.jpg,Airplane,825,921,346,444,96,98
297,2560,2560,JPEG,RGB,False,1,54442e49-5271-42bf-a8fb-a2cab30cfd49.jpg,Airplane,959,1055,345,453,96,108
298,2560,2560,JPEG,RGB,False,1,534ba32c-cde2-402b-9b47-1396cf0999e8.jpg,Airplane,772,869,0,72,97,72
299,2560,2560,JPEG,RGB,False,1,534ba32c-cde2-402b-9b47-1396cf0999e8.jpg,Airplane,964,1042,253,324,78,71
300,2560,2560,JPEG,RGB,False,1,534ba32c-cde2-402b-9b47-1396cf0999e8.jpg,Airplane,1047,1132,359,432,85,73
301,2560,2560,JPEG,RGB,False,1,534ba32c-cde2-402b-9b47-1396cf0999e8.jpg,Airplane,1107,1190,450,537,83,87
302,2560,2560,JPEG,RGB,False,1,534ba32c-cde2-402b-9b47-1396cf0999e8.jpg,Airplane,1168,1283,537,660,115,123
303,2560,2560,JPEG,RGB,False,1,534ba32c-cde2-402b-9b47-1396cf0999e8.jpg,Airplane,1260,1330,821,909,70,88
304,2560,2560,JPEG,RGB,False,1,534ba32c-cde2-402b-9b47-1396cf0999e8.jpg,Airplane,1248,1318,1031,1113,70,82
305,2560,2560,JPEG,RGB,False,1,534ba32c-cde2-402b-9b47-1396cf0999e8.jpg,Airplane,1846,1923,692,782,77,90
306,2560,2560,JPEG,RGB,False,1,534ba32c-cde2-402b-9b47-1396cf0999e8.jpg,Airplane,1175,1309,1586,1719,134,133
307,2560,2560,JPEG,RGB,False,1,534ba32c-cde2-402b-9b47-1396cf0999e8.jpg,Airplane,1154,1242,1878,1955,88,77
308,2560,2560,JPEG,RGB,False,1,534ba32c-cde2-402b-9b47-1396cf0999e8.jpg,Airplane,1124,1208,2008,2081,84,73
309,2560,2560,JPEG,RGB,False,1,534ba32c-cde2-402b-9b47-1396cf0999e8.jpg,Airplane,908,1033,2318,2439,125,121
310,2560,2560,JPEG,RGB,False,1,534ba32c-cde2-402b-9b47-1396cf0999e8.jpg,Airplane,805,934,2395,2529,129,134
311,2560,2560,JPEG,RGB,False,1,534ba32c-cde2-402b-9b47-1396cf0999e8.jpg,Truncated_airplane,553,662,2526,2560,109,34
312,2560,2560,JPEG,RGB,False,1,ca7b1077-0d37-4ada-9d56-0e66f864935e.jpg,Airplane,2053,2155,826,926,102,100
313,2560,2560,JPEG,RGB,False,1,ca7b1077-0d37-4ada-9d56-0e66f864935e.jpg,Airplane,2328,2524,37,234,196,197
314,2560,2560,JPEG,RGB,False,1,ca7b1077-0d37-4ada-9d56-0e66f864935e.jpg,Airplane,1398,1521,170,273,123,103
315,2560,2560,JPEG,RGB,False,1,ca7b1077-0d37-4ada-9d56-0e66f864935e.jpg,Airplane,1538,1681,567,691,143,124
316,2560,2560,JPEG,RGB,False,1,ca7b1077-0d37-4ada-9d56-0e66f864935e.jpg,Airplane,1663,1759,874,974,96,100
317,2560,2560,JPEG,RGB,False,1,ca7b1077-0d37-4ada-9d56-0e66f864935e.jpg,Airplane,791,943,791,962,152,171
318,2560,2560,JPEG,RGB,False,1,ca7b1077-0d37-4ada-9d56-0e66f864935e.jpg,Airplane,623,775,694,886,152,192
319,2560,2560,JPEG,RGB,False,1,ca7b1077-0d37-4ada-9d56-0e66f864935e.jpg,Airplane,493,562,726,825,69,99
320,2560,2560,JPEG,RGB,False,1,ca7b1077-0d37-4ada-9d56-0e66f864935e.jpg,Airplane,490,561,726,821,71,95
321,2560,2560,JPEG,RGB,False,1,ca7b1077-0d37-4ada-9d56-0e66f864935e.jpg,Airplane,621,773,687,881,152,194
322,2560,2560,JPEG,RGB,False,1,ca7b1077-0d37-4ada-9d56-0e66f864935e.jpg,Airplane,790,942,783,960,152,177
323,2560,2560,JPEG,RGB,False,1,ca7b1077-0d37-4ada-9d56-0e66f864935e.jpg,Airplane,2054,2156,828,927,102,99
324,2560,2560,JPEG,RGB,False,1,ca7b1077-0d37-4ada-9d56-0e66f864935e.jpg,Airplane,2332,2526,36,236,194,200
325,2560,2560,JPEG,RGB,False,1,ca7b1077-0d37-4ada-9d56-0e66f864935e.jpg,Airplane,1660,1765,874,976,105,102
326,2560,2560,JPEG,RGB,False,1,ca7b1077-0d37-4ada-9d56-0e66f864935e.jpg,Airplane,1537,1682,547,692,145,145
327,2560,2560,JPEG,RGB,False,1,ca7b1077-0d37-4ada-9d56-0e66f864935e.jpg,Airplane,1394,1521,167,282,127,115
328,2560,2560,JPEG,RGB,False,1,72fa2a77-cf8e-44a2-9ab2-f11ca63b4b72.jpg,Airplane,8,180,332,516,172,184
329,2560,2560,JPEG,RGB,False,1,72fa2a77-cf8e-44a2-9ab2-f11ca63b4b72.jpg,Airplane,2,171,894,1066,169,172
330,2560,2560,JPEG,RGB,False,1,72fa2a77-cf8e-44a2-9ab2-f11ca63b4b72.jpg,Airplane,5,188,1125,1315,183,190
331,2560,2560,JPEG,RGB,False,1,72fa2a77-cf8e-44a2-9ab2-f11ca63b4b72.jpg,Airplane,9,166,1382,1545,157,163
332,2560,2560,JPEG,RGB,False,1,72fa2a77-cf8e-44a2-9ab2-f11ca63b4b72.jpg,Airplane,8,168,1594,1759,160,165
333,2560,2560,JPEG,RGB,False,1,72fa2a77-cf8e-44a2-9ab2-f11ca63b4b72.jpg,Airplane,4,191,1796,1975,187,179
334,2560,2560,JPEG,RGB,False,1,72fa2a77-cf8e-44a2-9ab2-f11ca63b4b72.jpg,Airplane,530,716,1778,1952,186,174
335,2560,2560,JPEG,RGB,False,1,72fa2a77-cf8e-44a2-9ab2-f11ca63b4b72.jpg,Airplane,501,709,1374,1553,208,179
336,2560,2560,JPEG,RGB,False,1,72fa2a77-cf8e-44a2-9ab2-f11ca63b4b72.jpg,Airplane,512,718,865,1042,206,177
337,2560,2560,JPEG,RGB,False,1,72fa2a77-cf8e-44a2-9ab2-f11ca63b4b72.jpg,Airplane,529,706,591,751,177,160
338,2560,2560,JPEG,RGB,False,1,72fa2a77-cf8e-44a2-9ab2-f11ca63b4b72.jpg,Airplane,962,1136,343,512,174,169
339,2560,2560,JPEG,RGB,False,1,72fa2a77-cf8e-44a2-9ab2-f11ca63b4b72.jpg,Airplane,968,1170,559,777,202,218
340,2560,2560,JPEG,RGB,False,1,72fa2a77-cf8e-44a2-9ab2-f11ca63b4b72.jpg,Airplane,964,1174,844,1051,210,207
341,2560,2560,JPEG,RGB,False,1,72fa2a77-cf8e-44a2-9ab2-f11ca63b4b72.jpg,Airplane,969,1151,1099,1270,182,171
342,2560,2560,JPEG,RGB,False,1,72fa2a77-cf8e-44a2-9ab2-f11ca63b4b72.jpg,Airplane,963,1170,1357,1547,207,190
343,2560,2560,JPEG,RGB,False,1,72fa2a77-cf8e-44a2-9ab2-f11ca63b4b72.jpg,Airplane,973,1159,1595,1762,186,167
344,2560,2560,JPEG,RGB,False,1,72fa2a77-cf8e-44a2-9ab2-f11ca63b4b72.jpg,Airplane,973,1152,1798,1949,179,151
345,2560,2560,JPEG,RGB,False,1,72fa2a77-cf8e-44a2-9ab2-f11ca63b4b72.jpg,Airplane,974,1154,1999,2164,180,165
346,2560,2560,JPEG,RGB,False,1,72fa2a77-cf8e-44a2-9ab2-f11ca63b4b72.jpg,Airplane,415,627,2286,2475,212,189
347,2560,2560,JPEG,RGB,False,1,72fa2a77-cf8e-44a2-9ab2-f11ca63b4b72.jpg,Airplane,1916,2087,2017,2207,171,190
348,2560,2560,JPEG,RGB,False,1,72fa2a77-cf8e-44a2-9ab2-f11ca63b4b72.jpg,Airplane,1899,2097,1774,1940,198,166
349,2560,2560,JPEG,RGB,False,1,72fa2a77-cf8e-44a2-9ab2-f11ca63b4b72.jpg,Airplane,1911,2096,1577,1737,185,160
350,2560,2560,JPEG,RGB,False,1,72fa2a77-cf8e-44a2-9ab2-f11ca63b4b72.jpg,Airplane,1897,2094,1377,1535,197,158
351,2560,2560,JPEG,RGB,False,1,72fa2a77-cf8e-44a2-9ab2-f11ca63b4b72.jpg,Airplane,2144,2318,1458,1649,174,191
352,2560,2560,JPEG,RGB,False,1,72fa2a77-cf8e-44a2-9ab2-f11ca63b4b72.jpg,Airplane,1541,1668,1431,1521,127,90
353,2560,2560,JPEG,RGB,False,1,72fa2a77-cf8e-44a2-9ab2-f11ca63b4b72.jpg,Airplane,1488,1660,705,886,172,181
354,2560,2560,JPEG,RGB,False,1,72fa2a77-cf8e-44a2-9ab2-f11ca63b4b72.jpg,Airplane,1855,2076,630,860,221,230
355,2560,2560,JPEG,RGB,False,1,72fa2a77-cf8e-44a2-9ab2-f11ca63b4b72.jpg,Airplane,1882,2046,898,1064,164,166
356,2560,2560,JPEG,RGB,False,1,babb0ef2-ef2d-4cab-b3e2-230ae2418cdc.jpg,Airplane,2360,2546,1021,1238,186,217
357,2560,2560,JPEG,RGB,False,1,babb0ef2-ef2d-4cab-b3e2-230ae2418cdc.jpg,Airplane,2224,2327,970,1091,103,121
358,2560,2560,JPEG,RGB,False,1,babb0ef2-ef2d-4cab-b3e2-230ae2418cdc.jpg,Airplane,1828,1982,795,964,154,169
359,2560,2560,JPEG,RGB,False,1,babb0ef2-ef2d-4cab-b3e2-230ae2418cdc.jpg,Airplane,1708,1815,755,867,107,112
360,2560,2560,JPEG,RGB,False,1,babb0ef2-ef2d-4cab-b3e2-230ae2418cdc.jpg,Airplane,1769,1879,1011,1112,110,101
361,2560,2560,JPEG,RGB,False,1,babb0ef2-ef2d-4cab-b3e2-230ae2418cdc.jpg,Airplane,1873,2027,1273,1404,154,131
362,2560,2560,JPEG,RGB,False,1,babb0ef2-ef2d-4cab-b3e2-230ae2418cdc.jpg,Airplane,1734,1899,1166,1352,165,186
363,2560,2560,JPEG,RGB,False,1,babb0ef2-ef2d-4cab-b3e2-230ae2418cdc.jpg,Airplane,1752,1847,1574,1687,95,113
364,2560,2560,JPEG,RGB,False,1,babb0ef2-ef2d-4cab-b3e2-230ae2418cdc.jpg,Airplane,1574,1723,1520,1687,149,167
365,2560,2560,JPEG,RGB,False,1,babb0ef2-ef2d-4cab-b3e2-230ae2418cdc.jpg,Airplane,1393,1569,1427,1606,176,179
366,2560,2560,JPEG,RGB,False,1,babb0ef2-ef2d-4cab-b3e2-230ae2418cdc.jpg,Airplane,875,973,1065,1164,98,99
367,2560,2560,JPEG,RGB,False,1,babb0ef2-ef2d-4cab-b3e2-230ae2418cdc.jpg,Airplane,714,845,973,1079,131,106
368,2560,2560,JPEG,RGB,False,1,babb0ef2-ef2d-4cab-b3e2-230ae2418cdc.jpg,Airplane,581,706,1049,1146,125,97
369,2560,2560,JPEG,RGB,False,1,babb0ef2-ef2d-4cab-b3e2-230ae2418cdc.jpg,Airplane,506,609,1180,1258,103,78
370,2560,2560,JPEG,RGB,False,1,babb0ef2-ef2d-4cab-b3e2-230ae2418cdc.jpg,Airplane,858,1046,1214,1385,188,171
371,2560,2560,JPEG,RGB,False,1,babb0ef2-ef2d-4cab-b3e2-230ae2418cdc.jpg,Airplane,774,966,1406,1570,192,164
372,2560,2560,JPEG,RGB,False,1,babb0ef2-ef2d-4cab-b3e2-230ae2418cdc.jpg,Airplane,1094,1287,1546,1718,193,172
373,2560,2560,JPEG,RGB,False,1,babb0ef2-ef2d-4cab-b3e2-230ae2418cdc.jpg,Airplane,1050,1240,1748,1905,190,157
374,2560,2560,JPEG,RGB,False,1,babb0ef2-ef2d-4cab-b3e2-230ae2418cdc.jpg,Airplane,753,858,1605,1699,105,94
375,2560,2560,JPEG,RGB,False,1,babb0ef2-ef2d-4cab-b3e2-230ae2418cdc.jpg,Airplane,640,822,1707,1879,182,172
376,2560,2560,JPEG,RGB,False,1,babb0ef2-ef2d-4cab-b3e2-230ae2418cdc.jpg,Airplane,619,824,1897,2071,205,174
377,2560,2560,JPEG,RGB,False,1,babb0ef2-ef2d-4cab-b3e2-230ae2418cdc.jpg,Airplane,527,743,2146,2365,216,219
378,2560,2560,JPEG,RGB,False,1,babb0ef2-ef2d-4cab-b3e2-230ae2418cdc.jpg,Airplane,425,604,1299,1460,179,161
379,2560,2560,JPEG,RGB,False,1,babb0ef2-ef2d-4cab-b3e2-230ae2418cdc.jpg,Airplane,277,473,1573,1747,196,174
380,2560,2560,JPEG,RGB,False,1,babb0ef2-ef2d-4cab-b3e2-230ae2418cdc.jpg,Airplane,76,209,1498,1597,133,99
381,2560,2560,JPEG,RGB,False,1,babb0ef2-ef2d-4cab-b3e2-230ae2418cdc.jpg,Airplane,23,133,1639,1735,110,96
382,2560,2560,JPEG,RGB,False,1,babb0ef2-ef2d-4cab-b3e2-230ae2418cdc.jpg,Airplane,251,377,1745,1840,126,95
383,2560,2560,JPEG,RGB,False,1,babb0ef2-ef2d-4cab-b3e2-230ae2418cdc.jpg,Airplane,155,371,1867,2046,216,179
384,2560,2560,JPEG,RGB,False,1,babb0ef2-ef2d-4cab-b3e2-230ae2418cdc.jpg,Airplane,88,284,2044,2213,196,169
385,2560,2560,JPEG,RGB,False,1,babb0ef2-ef2d-4cab-b3e2-230ae2418cdc.jpg,Truncated_airplane,0,76,1725,1888,76,163
386,2560,2560,JPEG,RGB,False,1,29324dbf-6043-4521-bd83-44a97ffc5281.jpg,Airplane,625,754,320,429,129,109
387,2560,2560,JPEG,RGB,False,1,29324dbf-6043-4521-bd83-44a97ffc5281.jpg,Airplane,892,1013,497,603,121,106
388,2560,2560,JPEG,RGB,False,1,29324dbf-6043-4521-bd83-44a97ffc5281.jpg,Airplane,865,998,624,736,133,112
389,2560,2560,JPEG,RGB,False,1,29324dbf-6043-4521-bd83-44a97ffc5281.jpg,Airplane,680,793,731,859,113,128
390,2560,2560,JPEG,RGB,False,1,29324dbf-6043-4521-bd83-44a97ffc5281.jpg,Airplane,843,911,913,970,68,57
391,2560,2560,JPEG,RGB,False,1,29324dbf-6043-4521-bd83-44a97ffc5281.jpg,Airplane,2467,2529,1343,1404,62,61
392,2560,2560,JPEG,RGB,False,1,29324dbf-6043-4521-bd83-44a97ffc5281.jpg,Airplane,517,579,1344,1410,62,66
393,2560,2560,JPEG,RGB,False,1,29324dbf-6043-4521-bd83-44a97ffc5281.jpg,Airplane,621,678,1363,1433,57,70
394,2560,2560,JPEG,RGB,False,1,29324dbf-6043-4521-bd83-44a97ffc5281.jpg,Airplane,689,754,1521,1581,65,60
395,2560,2560,JPEG,RGB,False,1,29324dbf-6043-4521-bd83-44a97ffc5281.jpg,Airplane,618,743,1611,1724,125,113
396,2560,2560,JPEG,RGB,False,1,29324dbf-6043-4521-bd83-44a97ffc5281.jpg,Airplane,222,355,1854,1992,133,138
397,2560,2560,JPEG,RGB,False,1,29324dbf-6043-4521-bd83-44a97ffc5281.jpg,Airplane,628,694,1767,1835,66,68
398,2560,2560,JPEG,RGB,False,1,29324dbf-6043-4521-bd83-44a97ffc5281.jpg,Airplane,518,648,1992,2109,130,117
399,2560,2560,JPEG,RGB,False,1,29324dbf-6043-4521-bd83-44a97ffc5281.jpg,Airplane,939,1041,1574,1677,102,103
400,2560,2560,JPEG,RGB,False,1,29324dbf-6043-4521-bd83-44a97ffc5281.jpg,Airplane,868,993,1822,1940,125,118
401,2560,2560,JPEG,RGB,False,1,29324dbf-6043-4521-bd83-44a97ffc5281.jpg,Airplane,837,964,1954,2066,127,112
402,2560,2560,JPEG,RGB,False,1,29324dbf-6043-4521-bd83-44a97ffc5281.jpg,Airplane,812,924,2081,2190,112,109
403,2560,2560,JPEG,RGB,False,1,29324dbf-6043-4521-bd83-44a97ffc5281.jpg,Airplane,1208,1270,1511,1586,62,75
404,2560,2560,JPEG,RGB,False,1,29324dbf-6043-4521-bd83-44a97ffc5281.jpg,Airplane,1336,1392,1547,1610,56,63
405,2560,2560,JPEG,RGB,False,1,29324dbf-6043-4521-bd83-44a97ffc5281.jpg,Airplane,1442,1507,1587,1664,65,77
406,2560,2560,JPEG,RGB,False,1,29324dbf-6043-4521-bd83-44a97ffc5281.jpg,Airplane,1707,1810,1637,1744,103,107
407,2560,2560,JPEG,RGB,False,1,29324dbf-6043-4521-bd83-44a97ffc5281.jpg,Airplane,1968,2029,1726,1797,61,71
408,2560,2560,JPEG,RGB,False,1,29324dbf-6043-4521-bd83-44a97ffc5281.jpg,Airplane,1232,1363,2046,2162,131,116
409,2560,2560,JPEG,RGB,False,1,29324dbf-6043-4521-bd83-44a97ffc5281.jpg,Airplane,1585,1670,1897,1983,85,86
410,2560,2560,JPEG,RGB,False,1,29324dbf-6043-4521-bd83-44a97ffc5281.jpg,Airplane,2295,2410,1921,2027,115,106
411,2560,2560,JPEG,RGB,False,1,29324dbf-6043-4521-bd83-44a97ffc5281.jpg,Airplane,2274,2343,2071,2135,69,64
412,2560,2560,JPEG,RGB,False,1,29324dbf-6043-4521-bd83-44a97ffc5281.jpg,Airplane,2377,2484,2238,2365,107,127
413,2560,2560,JPEG,RGB,False,1,29324dbf-6043-4521-bd83-44a97ffc5281.jpg,Airplane,1930,2064,2095,2205,134,110
414,2560,2560,JPEG,RGB,False,1,29324dbf-6043-4521-bd83-44a97ffc5281.jpg,Airplane,1900,2037,2223,2330,137,107
415,2560,2560,JPEG,RGB,False,1,29324dbf-6043-4521-bd83-44a97ffc5281.jpg,Airplane,1868,2007,2345,2462,139,117
416,2560,2560,JPEG,RGB,False,1,29324dbf-6043-4521-bd83-44a97ffc5281.jpg,Airplane,1517,1618,2126,2234,101,108
417,2560,2560,JPEG,RGB,False,1,29324dbf-6043-4521-bd83-44a97ffc5281.jpg,Airplane,2175,2235,2448,2513,60,65
418,2560,2560,JPEG,RGB,False,1,140d04fd-dea7-4d46-bce2-e20f73e155da.jpg,Airplane,1289,1412,99,219,123,120
419,2560,2560,JPEG,RGB,False,1,140d04fd-dea7-4d46-bce2-e20f73e155da.jpg,Airplane,1049,1163,229,360,114,131
420,2560,2560,JPEG,RGB,False,1,140d04fd-dea7-4d46-bce2-e20f73e155da.jpg,Airplane,923,1041,301,428,118,127
421,2560,2560,JPEG,RGB,False,1,140d04fd-dea7-4d46-bce2-e20f73e155da.jpg,Airplane,442,586,750,871,144,121
422,2560,2560,JPEG,RGB,False,1,140d04fd-dea7-4d46-bce2-e20f73e155da.jpg,Airplane,423,543,965,1086,120,121
423,2560,2560,JPEG,RGB,False,1,140d04fd-dea7-4d46-bce2-e20f73e155da.jpg,Airplane,555,673,883,1016,118,133
424,2560,2560,JPEG,RGB,False,1,140d04fd-dea7-4d46-bce2-e20f73e155da.jpg,Airplane,675,793,806,925,118,119
425,2560,2560,JPEG,RGB,False,1,140d04fd-dea7-4d46-bce2-e20f73e155da.jpg,Airplane,843,961,718,835,118,117
426,2560,2560,JPEG,RGB,False,1,140d04fd-dea7-4d46-bce2-e20f73e155da.jpg,Airplane,977,1090,641,762,113,121
427,2560,2560,JPEG,RGB,False,1,140d04fd-dea7-4d46-bce2-e20f73e155da.jpg,Airplane,1102,1228,552,694,126,142
428,2560,2560,JPEG,RGB,False,1,140d04fd-dea7-4d46-bce2-e20f73e155da.jpg,Airplane,1245,1357,477,620,112,143
429,2560,2560,JPEG,RGB,False,1,140d04fd-dea7-4d46-bce2-e20f73e155da.jpg,Airplane,1368,1495,392,543,127,151
430,2560,2560,JPEG,RGB,False,1,140d04fd-dea7-4d46-bce2-e20f73e155da.jpg,Airplane,1110,1271,999,1115,161,116
431,2560,2560,JPEG,RGB,False,1,140d04fd-dea7-4d46-bce2-e20f73e155da.jpg,Airplane,1187,1335,1128,1245,148,117
432,2560,2560,JPEG,RGB,False,1,140d04fd-dea7-4d46-bce2-e20f73e155da.jpg,Airplane,1252,1407,1264,1378,155,114
433,2560,2560,JPEG,RGB,False,1,140d04fd-dea7-4d46-bce2-e20f73e155da.jpg,Airplane,1340,1502,1403,1538,162,135
434,2560,2560,JPEG,RGB,False,1,140d04fd-dea7-4d46-bce2-e20f73e155da.jpg,Airplane,1421,1577,1537,1664,156,127
435,2560,2560,JPEG,RGB,False,1,140d04fd-dea7-4d46-bce2-e20f73e155da.jpg,Airplane,1653,1774,1543,1692,121,149
436,2560,2560,JPEG,RGB,False,1,140d04fd-dea7-4d46-bce2-e20f73e155da.jpg,Airplane,1576,1719,1783,1903,143,120
437,2560,2560,JPEG,RGB,False,1,140d04fd-dea7-4d46-bce2-e20f73e155da.jpg,Airplane,1659,1803,1947,2069,144,122
438,2560,2560,JPEG,RGB,False,1,140d04fd-dea7-4d46-bce2-e20f73e155da.jpg,Airplane,1718,1841,2143,2258,123,115
439,2560,2560,JPEG,RGB,False,1,140d04fd-dea7-4d46-bce2-e20f73e155da.jpg,Airplane,1794,1937,2279,2398,143,119
440,2560,2560,JPEG,RGB,False,1,140d04fd-dea7-4d46-bce2-e20f73e155da.jpg,Airplane,2228,2333,2045,2172,105,127
441,2560,2560,JPEG,RGB,False,1,140d04fd-dea7-4d46-bce2-e20f73e155da.jpg,Airplane,2374,2464,1982,2093,90,111
442,2560,2560,JPEG,RGB,False,1,140d04fd-dea7-4d46-bce2-e20f73e155da.jpg,Airplane,2101,2250,1471,1596,149,125
443,2560,2560,JPEG,RGB,False,1,140d04fd-dea7-4d46-bce2-e20f73e155da.jpg,Airplane,1719,1817,1208,1278,98,70
444,2560,2560,JPEG,RGB,False,1,140d04fd-dea7-4d46-bce2-e20f73e155da.jpg,Airplane,1878,1952,1115,1184,74,69
445,2560,2560,JPEG,RGB,False,1,0263270b-e3ee-41dc-aeef-43ff77e66d5b.jpg,Airplane,1962,2048,413,482,86,69
446,2560,2560,JPEG,RGB,False,1,0263270b-e3ee-41dc-aeef-43ff77e66d5b.jpg,Airplane,767,828,306,360,61,54
447,2560,2560,JPEG,RGB,False,1,0263270b-e3ee-41dc-aeef-43ff77e66d5b.jpg,Airplane,978,1103,676,799,125,123
448,2560,2560,JPEG,RGB,False,1,0263270b-e3ee-41dc-aeef-43ff77e66d5b.jpg,Airplane,1228,1298,785,839,70,54
449,2560,2560,JPEG,RGB,False,1,0263270b-e3ee-41dc-aeef-43ff77e66d5b.jpg,Airplane,1197,1266,851,902,69,51
450,2560,2560,JPEG,RGB,False,1,0263270b-e3ee-41dc-aeef-43ff77e66d5b.jpg,Airplane,418,527,632,714,109,82
451,2560,2560,JPEG,RGB,False,1,0263270b-e3ee-41dc-aeef-43ff77e66d5b.jpg,Airplane,423,522,736,809,99,73
452,2560,2560,JPEG,RGB,False,1,0263270b-e3ee-41dc-aeef-43ff77e66d5b.jpg,Airplane,664,752,842,950,88,108
453,2560,2560,JPEG,RGB,False,1,0263270b-e3ee-41dc-aeef-43ff77e66d5b.jpg,Airplane,554,643,793,898,89,105
454,2560,2560,JPEG,RGB,False,1,0263270b-e3ee-41dc-aeef-43ff77e66d5b.jpg,Airplane,869,963,948,1064,94,116
455,2560,2560,JPEG,RGB,False,1,0263270b-e3ee-41dc-aeef-43ff77e66d5b.jpg,Airplane,284,410,1053,1150,126,97
456,2560,2560,JPEG,RGB,False,1,0263270b-e3ee-41dc-aeef-43ff77e66d5b.jpg,Airplane,1572,1651,876,976,79,100
457,2560,2560,JPEG,RGB,False,1,0263270b-e3ee-41dc-aeef-43ff77e66d5b.jpg,Airplane,1484,1608,983,1098,124,115
458,2560,2560,JPEG,RGB,False,1,0263270b-e3ee-41dc-aeef-43ff77e66d5b.jpg,Airplane,1678,1761,942,1025,83,83
459,2560,2560,JPEG,RGB,False,1,0263270b-e3ee-41dc-aeef-43ff77e66d5b.jpg,Airplane,1767,1873,992,1070,106,78
460,2560,2560,JPEG,RGB,False,1,0263270b-e3ee-41dc-aeef-43ff77e66d5b.jpg,Airplane,1911,1996,1067,1156,85,89
461,2560,2560,JPEG,RGB,False,1,0263270b-e3ee-41dc-aeef-43ff77e66d5b.jpg,Airplane,1975,2062,1149,1241,87,92
462,2560,2560,JPEG,RGB,False,1,0263270b-e3ee-41dc-aeef-43ff77e66d5b.jpg,Airplane,1682,1776,1272,1335,94,63
463,2560,2560,JPEG,RGB,False,1,0263270b-e3ee-41dc-aeef-43ff77e66d5b.jpg,Airplane,2114,2185,1195,1284,71,89
464,2560,2560,JPEG,RGB,False,1,0263270b-e3ee-41dc-aeef-43ff77e66d5b.jpg,Airplane,2205,2284,1220,1311,79,91
465,2560,2560,JPEG,RGB,False,1,0263270b-e3ee-41dc-aeef-43ff77e66d5b.jpg,Airplane,2280,2370,1298,1380,90,82
466,2560,2560,JPEG,RGB,False,1,0263270b-e3ee-41dc-aeef-43ff77e66d5b.jpg,Airplane,2312,2396,1399,1472,84,73
467,2560,2560,JPEG,RGB,False,1,0263270b-e3ee-41dc-aeef-43ff77e66d5b.jpg,Airplane,2363,2453,1481,1562,90,81
468,2560,2560,JPEG,RGB,False,1,0263270b-e3ee-41dc-aeef-43ff77e66d5b.jpg,Airplane,2187,2263,1720,1803,76,83
469,2560,2560,JPEG,RGB,False,1,0263270b-e3ee-41dc-aeef-43ff77e66d5b.jpg,Airplane,2003,2072,1655,1736,69,81
470,2560,2560,JPEG,RGB,False,1,0263270b-e3ee-41dc-aeef-43ff77e66d5b.jpg,Airplane,2019,2093,1989,2075,74,86
471,2560,2560,JPEG,RGB,False,1,0263270b-e3ee-41dc-aeef-43ff77e66d5b.jpg,Airplane,1914,1985,2242,2313,71,71
472,2560,2560,JPEG,RGB,False,1,0263270b-e3ee-41dc-aeef-43ff77e66d5b.jpg,Airplane,1821,1901,2187,2268,80,81
473,2560,2560,JPEG,RGB,False,1,0263270b-e3ee-41dc-aeef-43ff77e66d5b.jpg,Airplane,1707,1807,2114,2236,100,122
474,2560,2560,JPEG,RGB,False,1,0263270b-e3ee-41dc-aeef-43ff77e66d5b.jpg,Airplane,1822,1915,1885,1978,93,93
475,2560,2560,JPEG,RGB,False,1,0263270b-e3ee-41dc-aeef-43ff77e66d5b.jpg,Airplane,1745,1820,2450,2533,75,83
476,2560,2560,JPEG,RGB,False,1,0263270b-e3ee-41dc-aeef-43ff77e66d5b.jpg,Truncated_airplane,1826,1916,2495,2558,90,63
477,2560,2560,JPEG,RGB,False,1,0263270b-e3ee-41dc-aeef-43ff77e66d5b.jpg,Airplane,1018,1092,1226,1308,74,82
478,2560,2560,JPEG,RGB,False,1,0263270b-e3ee-41dc-aeef-43ff77e66d5b.jpg,Airplane,776,855,1428,1517,79,89
479,2560,2560,JPEG,RGB,False,1,0263270b-e3ee-41dc-aeef-43ff77e66d5b.jpg,Airplane,650,725,1408,1487,75,79
480,2560,2560,JPEG,RGB,False,1,0263270b-e3ee-41dc-aeef-43ff77e66d5b.jpg,Airplane,489,618,1311,1469,129,158
481,2560,2560,JPEG,RGB,False,1,0263270b-e3ee-41dc-aeef-43ff77e66d5b.jpg,Airplane,403,485,1218,1319,82,101
482,2560,2560,JPEG,RGB,False,1,0263270b-e3ee-41dc-aeef-43ff77e66d5b.jpg,Airplane,216,344,1173,1328,128,155
483,2560,2560,JPEG,RGB,False,1,0263270b-e3ee-41dc-aeef-43ff77e66d5b.jpg,Airplane,77,205,1096,1257,128,161
484,2560,2560,JPEG,RGB,False,1,0263270b-e3ee-41dc-aeef-43ff77e66d5b.jpg,Airplane,197,318,1485,1625,121,140
485,2560,2560,JPEG,RGB,False,1,3463b88d-1e11-4c04-9868-e8c72d510556.jpg,Airplane,616,706,369,470,90,101
486,2560,2560,JPEG,RGB,False,1,3463b88d-1e11-4c04-9868-e8c72d510556.jpg,Airplane,739,870,388,527,131,139
487,2560,2560,JPEG,RGB,False,1,3463b88d-1e11-4c04-9868-e8c72d510556.jpg,Airplane,1365,1463,403,517,98,114
488,2560,2560,JPEG,RGB,False,1,3463b88d-1e11-4c04-9868-e8c72d510556.jpg,Airplane,1501,1647,41,168,146,127
489,2560,2560,JPEG,RGB,False,1,3463b88d-1e11-4c04-9868-e8c72d510556.jpg,Airplane,1847,1959,47,173,112,126
490,2560,2560,JPEG,RGB,False,1,3463b88d-1e11-4c04-9868-e8c72d510556.jpg,Airplane,1767,1925,611,770,158,159
491,2560,2560,JPEG,RGB,False,1,3463b88d-1e11-4c04-9868-e8c72d510556.jpg,Airplane,1542,1716,938,1070,174,132
492,2560,2560,JPEG,RGB,False,1,3463b88d-1e11-4c04-9868-e8c72d510556.jpg,Airplane,1704,1848,1098,1217,144,119
493,2560,2560,JPEG,RGB,False,1,3463b88d-1e11-4c04-9868-e8c72d510556.jpg,Airplane,1520,1692,1474,1637,172,163
494,2560,2560,JPEG,RGB,False,1,3463b88d-1e11-4c04-9868-e8c72d510556.jpg,Airplane,1986,2145,1857,1984,159,127
495,2560,2560,JPEG,RGB,False,1,3463b88d-1e11-4c04-9868-e8c72d510556.jpg,Airplane,1686,1779,2196,2274,93,78
496,2560,2560,JPEG,RGB,False,1,3463b88d-1e11-4c04-9868-e8c72d510556.jpg,Airplane,1572,1668,1882,1974,96,92
497,2560,2560,JPEG,RGB,False,1,3463b88d-1e11-4c04-9868-e8c72d510556.jpg,Airplane,1032,1193,2394,2523,161,129
498,2560,2560,JPEG,RGB,False,1,3463b88d-1e11-4c04-9868-e8c72d510556.jpg,Airplane,996,1180,2203,2359,184,156
499,2560,2560,JPEG,RGB,False,1,3463b88d-1e11-4c04-9868-e8c72d510556.jpg,Airplane,928,1120,1553,1710,192,157
500,2560,2560,JPEG,RGB,False,1,3463b88d-1e11-4c04-9868-e8c72d510556.jpg,Airplane,904,1075,1363,1505,171,142
501,2560,2560,JPEG,RGB,False,1,3463b88d-1e11-4c04-9868-e8c72d510556.jpg,Airplane,511,665,1413,1545,154,132
502,2560,2560,JPEG,RGB,False,1,3463b88d-1e11-4c04-9868-e8c72d510556.jpg,Airplane,870,1029,1183,1300,159,117
503,2560,2560,JPEG,RGB,False,1,3463b88d-1e11-4c04-9868-e8c72d510556.jpg,Airplane,798,947,1022,1160,149,138
504,2560,2560,JPEG,RGB,False,1,3463b88d-1e11-4c04-9868-e8c72d510556.jpg,Airplane,630,741,2264,2354,111,90
505,2560,2560,JPEG,RGB,False,1,7c2da441-819f-4ddd-8293-f4be5213d69e.jpg,Airplane,1547,1636,702,805,89,103
506,2560,2560,JPEG,RGB,False,1,7c2da441-819f-4ddd-8293-f4be5213d69e.jpg,Airplane,1944,2158,1370,1586,214,216
507,2560,2560,JPEG,RGB,False,1,7c2da441-819f-4ddd-8293-f4be5213d69e.jpg,Airplane,2285,2442,1448,1596,157,148
508,2560,2560,JPEG,RGB,False,1,7c2da441-819f-4ddd-8293-f4be5213d69e.jpg,Airplane,2342,2520,1033,1241,178,208
509,2560,2560,JPEG,RGB,False,1,7c2da441-819f-4ddd-8293-f4be5213d69e.jpg,Airplane,1084,1285,1546,1716,201,170
510,2560,2560,JPEG,RGB,False,1,7c2da441-819f-4ddd-8293-f4be5213d69e.jpg,Airplane,998,1221,1746,1931,223,185
511,2560,2560,JPEG,RGB,False,1,7c2da441-819f-4ddd-8293-f4be5213d69e.jpg,Airplane,951,1031,1870,1978,80,108
512,2560,2560,JPEG,RGB,False,1,7c2da441-819f-4ddd-8293-f4be5213d69e.jpg,Airplane,597,793,1899,2070,196,171
513,2560,2560,JPEG,RGB,False,1,7c2da441-819f-4ddd-8293-f4be5213d69e.jpg,Airplane,452,596,1658,1840,144,182
514,2560,2560,JPEG,RGB,False,1,7c2da441-819f-4ddd-8293-f4be5213d69e.jpg,Airplane,271,439,1594,1736,168,142
515,2560,2560,JPEG,RGB,False,1,7c2da441-819f-4ddd-8293-f4be5213d69e.jpg,Airplane,370,475,1448,1545,105,97
516,2560,2560,JPEG,RGB,False,1,7c2da441-819f-4ddd-8293-f4be5213d69e.jpg,Airplane,489,600,1179,1276,111,97
517,2560,2560,JPEG,RGB,False,1,7c2da441-819f-4ddd-8293-f4be5213d69e.jpg,Airplane,860,941,1062,1159,81,97
518,2560,2560,JPEG,RGB,False,1,7c2da441-819f-4ddd-8293-f4be5213d69e.jpg,Airplane,901,1007,1270,1355,106,85
519,2560,2560,JPEG,RGB,False,1,7c2da441-819f-4ddd-8293-f4be5213d69e.jpg,Airplane,1549,1659,1123,1270,110,147
520,2560,2560,JPEG,RGB,False,1,7c2da441-819f-4ddd-8293-f4be5213d69e.jpg,Airplane,145,234,1367,1440,89,73
521,2560,2560,JPEG,RGB,False,1,7c2da441-819f-4ddd-8293-f4be5213d69e.jpg,Airplane,76,252,2042,2205,176,163
522,2560,2560,JPEG,RGB,False,1,7c2da441-819f-4ddd-8293-f4be5213d69e.jpg,Airplane,1539,1699,1531,1700,160,169
523,2560,2560,JPEG,RGB,False,1,7c2da441-819f-4ddd-8293-f4be5213d69e.jpg,Airplane,1741,1821,1577,1679,80,102
524,2560,2560,JPEG,RGB,False,1,7c2da441-819f-4ddd-8293-f4be5213d69e.jpg,Airplane,736,839,1610,1702,103,92
525,2560,2560,JPEG,RGB,False,1,7c2da441-819f-4ddd-8293-f4be5213d69e.jpg,Airplane,756,928,1413,1566,172,153
526,2560,2560,JPEG,RGB,False,1,0641acc3-c0b9-4f9d-b0ba-7ad18aa08864.jpg,Airplane,171,242,216,294,71,78
527,2560,2560,JPEG,RGB,False,1,0641acc3-c0b9-4f9d-b0ba-7ad18aa08864.jpg,Airplane,406,472,357,421,66,64
528,2560,2560,JPEG,RGB,False,1,0641acc3-c0b9-4f9d-b0ba-7ad18aa08864.jpg,Airplane,617,673,492,570,56,78
529,2560,2560,JPEG,RGB,False,1,0641acc3-c0b9-4f9d-b0ba-7ad18aa08864.jpg,Airplane,678,733,572,636,55,64
530,2560,2560,JPEG,RGB,False,1,0641acc3-c0b9-4f9d-b0ba-7ad18aa08864.jpg,Airplane,737,807,551,614,70,63
531,2560,2560,JPEG,RGB,False,1,0641acc3-c0b9-4f9d-b0ba-7ad18aa08864.jpg,Airplane,777,832,638,698,55,60
532,2560,2560,JPEG,RGB,False,1,0641acc3-c0b9-4f9d-b0ba-7ad18aa08864.jpg,Airplane,338,412,735,805,74,70
533,2560,2560,JPEG,RGB,False,1,0641acc3-c0b9-4f9d-b0ba-7ad18aa08864.jpg,Airplane,979,1028,746,799,49,53
534,2560,2560,JPEG,RGB,False,1,0641acc3-c0b9-4f9d-b0ba-7ad18aa08864.jpg,Airplane,1012,1049,701,742,37,41
535,2560,2560,JPEG,RGB,False,1,0641acc3-c0b9-4f9d-b0ba-7ad18aa08864.jpg,Airplane,1218,1268,829,877,50,48
536,2560,2560,JPEG,RGB,False,1,0641acc3-c0b9-4f9d-b0ba-7ad18aa08864.jpg,Airplane,1261,1321,864,921,60,57
537,2560,2560,JPEG,RGB,False,1,0641acc3-c0b9-4f9d-b0ba-7ad18aa08864.jpg,Airplane,1269,1326,931,969,57,38
538,2560,2560,JPEG,RGB,False,1,0641acc3-c0b9-4f9d-b0ba-7ad18aa08864.jpg,Airplane,1234,1279,938,994,45,56
539,2560,2560,JPEG,RGB,False,1,0641acc3-c0b9-4f9d-b0ba-7ad18aa08864.jpg,Airplane,1691,1764,492,567,73,75
540,2560,2560,JPEG,RGB,False,1,0641acc3-c0b9-4f9d-b0ba-7ad18aa08864.jpg,Airplane,1797,1865,745,803,68,58
541,2560,2560,JPEG,RGB,False,1,0641acc3-c0b9-4f9d-b0ba-7ad18aa08864.jpg,Airplane,1750,1822,822,884,72,62
542,2560,2560,JPEG,RGB,False,1,0641acc3-c0b9-4f9d-b0ba-7ad18aa08864.jpg,Airplane,1854,1999,1251,1413,145,162
543,2560,2560,JPEG,RGB,False,1,0641acc3-c0b9-4f9d-b0ba-7ad18aa08864.jpg,Airplane,613,750,1732,1846,137,114
544,2560,2560,JPEG,RGB,False,1,0641acc3-c0b9-4f9d-b0ba-7ad18aa08864.jpg,Airplane,845,920,1881,1955,75,74
545,2560,2560,JPEG,RGB,False,1,0641acc3-c0b9-4f9d-b0ba-7ad18aa08864.jpg,Airplane,993,1064,1972,2038,71,66
546,2560,2560,JPEG,RGB,False,1,0641acc3-c0b9-4f9d-b0ba-7ad18aa08864.jpg,Airplane,1131,1293,1647,1766,162,119
547,2560,2560,JPEG,RGB,False,1,0641acc3-c0b9-4f9d-b0ba-7ad18aa08864.jpg,Airplane,1611,1754,2354,2473,143,119
548,2560,2560,JPEG,RGB,False,1,38ff8d64-3460-4f83-bf9c-383832aeba0d.jpg,Airplane,1743,1852,2306,2429,109,123
549,2560,2560,JPEG,RGB,False,1,38ff8d64-3460-4f83-bf9c-383832aeba0d.jpg,Airplane,2015,2096,2038,2101,81,63
550,2560,2560,JPEG,RGB,False,1,38ff8d64-3460-4f83-bf9c-383832aeba0d.jpg,Airplane,1702,1813,2122,2217,111,95
551,2560,2560,JPEG,RGB,False,1,38ff8d64-3460-4f83-bf9c-383832aeba0d.jpg,Airplane,1607,1719,2012,2106,112,94
552,2560,2560,JPEG,RGB,False,1,38ff8d64-3460-4f83-bf9c-383832aeba0d.jpg,Airplane,1755,1862,1708,1810,107,102
553,2560,2560,JPEG,RGB,False,1,38ff8d64-3460-4f83-bf9c-383832aeba0d.jpg,Airplane,1718,1788,1619,1678,70,59
554,2560,2560,JPEG,RGB,False,1,38ff8d64-3460-4f83-bf9c-383832aeba0d.jpg,Airplane,1547,1612,1932,1993,65,61
555,2560,2560,JPEG,RGB,False,1,38ff8d64-3460-4f83-bf9c-383832aeba0d.jpg,Airplane,1779,1838,1209,1280,59,71
556,2560,2560,JPEG,RGB,False,1,38ff8d64-3460-4f83-bf9c-383832aeba0d.jpg,Airplane,1887,1948,887,965,61,78
557,2560,2560,JPEG,RGB,False,1,38ff8d64-3460-4f83-bf9c-383832aeba0d.jpg,Airplane,1958,2025,927,1000,67,73
558,2560,2560,JPEG,RGB,False,1,38ff8d64-3460-4f83-bf9c-383832aeba0d.jpg,Airplane,2306,2369,618,692,63,74
559,2560,2560,JPEG,RGB,False,1,38ff8d64-3460-4f83-bf9c-383832aeba0d.jpg,Airplane,2362,2423,339,417,61,78
560,2560,2560,JPEG,RGB,False,1,38ff8d64-3460-4f83-bf9c-383832aeba0d.jpg,Airplane,2253,2320,319,394,67,75
561,2560,2560,JPEG,RGB,False,1,38ff8d64-3460-4f83-bf9c-383832aeba0d.jpg,Airplane,2151,2221,285,361,70,76
562,2560,2560,JPEG,RGB,False,1,38ff8d64-3460-4f83-bf9c-383832aeba0d.jpg,Airplane,2283,2346,40,116,63,76
563,2560,2560,JPEG,RGB,False,1,38ff8d64-3460-4f83-bf9c-383832aeba0d.jpg,Airplane,2354,2420,65,139,66,74
564,2560,2560,JPEG,RGB,False,1,38ff8d64-3460-4f83-bf9c-383832aeba0d.jpg,Airplane,2427,2492,79,157,65,78
565,2560,2560,JPEG,RGB,False,1,38ff8d64-3460-4f83-bf9c-383832aeba0d.jpg,Airplane,1486,1545,1799,1883,59,84
566,2560,2560,JPEG,RGB,False,1,38ff8d64-3460-4f83-bf9c-383832aeba0d.jpg,Airplane,1258,1327,2260,2320,69,60
567,2560,2560,JPEG,RGB,False,1,38ff8d64-3460-4f83-bf9c-383832aeba0d.jpg,Airplane,1318,1394,2349,2411,76,62
568,2560,2560,JPEG,RGB,False,1,38ff8d64-3460-4f83-bf9c-383832aeba0d.jpg,Airplane,1394,1462,2430,2492,68,62
569,2560,2560,JPEG,RGB,False,1,38ff8d64-3460-4f83-bf9c-383832aeba0d.jpg,Truncated_airplane,1460,1528,2514,2559,68,45
570,2560,2560,JPEG,RGB,False,1,38ff8d64-3460-4f83-bf9c-383832aeba0d.jpg,Airplane,438,489,2431,2494,51,63
571,2560,2560,JPEG,RGB,False,1,38ff8d64-3460-4f83-bf9c-383832aeba0d.jpg,Airplane,516,560,2468,2524,44,56
572,2560,2560,JPEG,RGB,False,1,38ff8d64-3460-4f83-bf9c-383832aeba0d.jpg,Airplane,556,595,2171,2223,39,52
573,2560,2560,JPEG,RGB,False,1,38ff8d64-3460-4f83-bf9c-383832aeba0d.jpg,Airplane,508,545,2194,2249,37,55
574,2560,2560,JPEG,RGB,False,1,38ff8d64-3460-4f83-bf9c-383832aeba0d.jpg,Airplane,359,394,2264,2316,35,52
575,2560,2560,JPEG,RGB,False,1,38ff8d64-3460-4f83-bf9c-383832aeba0d.jpg,Airplane,310,345,2288,2344,35,56
576,2560,2560,JPEG,RGB,False,1,38ff8d64-3460-4f83-bf9c-383832aeba0d.jpg,Airplane,314,372,2067,2135,58,68
577,2560,2560,JPEG,RGB,False,1,38ff8d64-3460-4f83-bf9c-383832aeba0d.jpg,Airplane,215,279,2074,2152,64,78
578,2560,2560,JPEG,RGB,False,1,38ff8d64-3460-4f83-bf9c-383832aeba0d.jpg,Airplane,146,207,2114,2180,61,66
579,2560,2560,JPEG,RGB,False,1,38ff8d64-3460-4f83-bf9c-383832aeba0d.jpg,Airplane,64,124,2138,2214,60,76
580,2560,2560,JPEG,RGB,False,1,38ff8d64-3460-4f83-bf9c-383832aeba0d.jpg,Airplane,0,48,2134,2193,48,59
581,2560,2560,JPEG,RGB,False,1,38ff8d64-3460-4f83-bf9c-383832aeba0d.jpg,Airplane,196,300,1721,1829,104,108
582,2560,2560,JPEG,RGB,False,1,38ff8d64-3460-4f83-bf9c-383832aeba0d.jpg,Airplane,339,400,1680,1745,61,65
583,2560,2560,JPEG,RGB,False,1,38ff8d64-3460-4f83-bf9c-383832aeba0d.jpg,Airplane,460,518,1643,1719,58,76
584,2560,2560,JPEG,RGB,False,1,38ff8d64-3460-4f83-bf9c-383832aeba0d.jpg,Airplane,578,640,1586,1673,62,87
585,2560,2560,JPEG,RGB,False,1,38ff8d64-3460-4f83-bf9c-383832aeba0d.jpg,Airplane,144,208,1443,1516,64,73
586,2560,2560,JPEG,RGB,False,1,38ff8d64-3460-4f83-bf9c-383832aeba0d.jpg,Airplane,435,493,1311,1380,58,69
587,2560,2560,JPEG,RGB,False,1,38ff8d64-3460-4f83-bf9c-383832aeba0d.jpg,Airplane,540,594,1269,1338,54,69
588,2560,2560,JPEG,RGB,False,1,38ff8d64-3460-4f83-bf9c-383832aeba0d.jpg,Airplane,390,458,906,986,68,80
589,2560,2560,JPEG,RGB,False,1,38ff8d64-3460-4f83-bf9c-383832aeba0d.jpg,Airplane,475,540,589,660,65,71
590,2560,2560,JPEG,RGB,False,1,38ff8d64-3460-4f83-bf9c-383832aeba0d.jpg,Airplane,334,402,583,659,68,76
591,2560,2560,JPEG,RGB,False,1,38ff8d64-3460-4f83-bf9c-383832aeba0d.jpg,Airplane,559,629,185,258,70,73
592,2560,2560,JPEG,RGB,False,1,38ff8d64-3460-4f83-bf9c-383832aeba0d.jpg,Airplane,492,555,163,237,63,74
593,2560,2560,JPEG,RGB,False,1,38ff8d64-3460-4f83-bf9c-383832aeba0d.jpg,Airplane,408,467,144,214,59,70
594,2560,2560,JPEG,RGB,False,1,38ff8d64-3460-4f83-bf9c-383832aeba0d.jpg,Airplane,301,376,88,147,75,59
595,2560,2560,JPEG,RGB,False,1,e9021b38-0b3c-484f-af2c-b36bbf765f85.jpg,Airplane,1223,1351,199,310,128,111
596,2560,2560,JPEG,RGB,False,1,e9021b38-0b3c-484f-af2c-b36bbf765f85.jpg,Airplane,1369,1477,278,412,108,134
597,2560,2560,JPEG,RGB,False,1,e9021b38-0b3c-484f-af2c-b36bbf765f85.jpg,Airplane,1089,1195,281,379,106,98
598,2560,2560,JPEG,RGB,False,1,e9021b38-0b3c-484f-af2c-b36bbf765f85.jpg,Airplane,1420,1529,500,604,109,104
599,2560,2560,JPEG,RGB,False,1,e9021b38-0b3c-484f-af2c-b36bbf765f85.jpg,Airplane,991,1121,403,515,130,112
600,2560,2560,JPEG,RGB,False,1,e9021b38-0b3c-484f-af2c-b36bbf765f85.jpg,Airplane,920,1100,530,692,180,162
601,2560,2560,JPEG,RGB,False,1,e9021b38-0b3c-484f-af2c-b36bbf765f85.jpg,Airplane,885,1002,699,797,117,98
602,2560,2560,JPEG,RGB,False,1,e9021b38-0b3c-484f-af2c-b36bbf765f85.jpg,Airplane,1265,1466,639,815,201,176
603,2560,2560,JPEG,RGB,False,1,e9021b38-0b3c-484f-af2c-b36bbf765f85.jpg,Airplane,792,976,815,981,184,166
604,2560,2560,JPEG,RGB,False,1,e9021b38-0b3c-484f-af2c-b36bbf765f85.jpg,Airplane,644,770,591,688,126,97
605,2560,2560,JPEG,RGB,False,1,e9021b38-0b3c-484f-af2c-b36bbf765f85.jpg,Airplane,578,708,730,831,130,101
606,2560,2560,JPEG,RGB,False,1,e9021b38-0b3c-484f-af2c-b36bbf765f85.jpg,Airplane,294,468,505,695,174,190
607,2560,2560,JPEG,RGB,False,1,e9021b38-0b3c-484f-af2c-b36bbf765f85.jpg,Airplane,122,304,567,785,182,218
608,2560,2560,JPEG,RGB,False,1,e9021b38-0b3c-484f-af2c-b36bbf765f85.jpg,Truncated_airplane,0,109,685,857,109,172
609,2560,2560,JPEG,RGB,False,1,e9021b38-0b3c-484f-af2c-b36bbf765f85.jpg,Airplane,75,178,1196,1317,103,121
610,2560,2560,JPEG,RGB,False,1,e9021b38-0b3c-484f-af2c-b36bbf765f85.jpg,Airplane,320,508,1133,1312,188,179
611,2560,2560,JPEG,RGB,False,1,e9021b38-0b3c-484f-af2c-b36bbf765f85.jpg,Airplane,648,856,1103,1283,208,180
612,2560,2560,JPEG,RGB,False,1,e9021b38-0b3c-484f-af2c-b36bbf765f85.jpg,Airplane,583,778,1273,1449,195,176
613,2560,2560,JPEG,RGB,False,1,e9021b38-0b3c-484f-af2c-b36bbf765f85.jpg,Airplane,219,333,1458,1574,114,116
614,2560,2560,JPEG,RGB,False,1,e9021b38-0b3c-484f-af2c-b36bbf765f85.jpg,Airplane,31,127,1536,1656,96,120
615,2560,2560,JPEG,RGB,False,1,e9021b38-0b3c-484f-af2c-b36bbf765f85.jpg,Airplane,971,1071,962,1084,100,122
616,2560,2560,JPEG,RGB,False,1,e9021b38-0b3c-484f-af2c-b36bbf765f85.jpg,Airplane,1126,1327,1125,1302,201,177
617,2560,2560,JPEG,RGB,False,1,e9021b38-0b3c-484f-af2c-b36bbf765f85.jpg,Airplane,1595,1788,771,953,193,182
618,2560,2560,JPEG,RGB,False,1,e9021b38-0b3c-484f-af2c-b36bbf765f85.jpg,Airplane,1528,1734,969,1146,206,177
619,2560,2560,JPEG,RGB,False,1,e9021b38-0b3c-484f-af2c-b36bbf765f85.jpg,Airplane,1887,2070,654,845,183,191
620,2560,2560,JPEG,RGB,False,1,e9021b38-0b3c-484f-af2c-b36bbf765f85.jpg,Airplane,2050,2225,737,942,175,205
621,2560,2560,JPEG,RGB,False,1,e9021b38-0b3c-484f-af2c-b36bbf765f85.jpg,Airplane,2169,2272,202,306,103,104
622,2560,2560,JPEG,RGB,False,1,e9021b38-0b3c-484f-af2c-b36bbf765f85.jpg,Airplane,2046,2208,326,513,162,187
623,2560,2560,JPEG,RGB,False,1,e9021b38-0b3c-484f-af2c-b36bbf765f85.jpg,Airplane,2242,2378,425,583,136,158
624,2560,2560,JPEG,RGB,False,1,e9021b38-0b3c-484f-af2c-b36bbf765f85.jpg,Airplane,2051,2262,1573,1759,211,186
625,2560,2560,JPEG,RGB,False,1,e9021b38-0b3c-484f-af2c-b36bbf765f85.jpg,Truncated_airplane,2453,2566,621,783,113,162
626,2560,2560,JPEG,RGB,False,1,e9021b38-0b3c-484f-af2c-b36bbf765f85.jpg,Truncated_airplane,2068,2169,0,66,101,66
627,2560,2560,JPEG,RGB,False,1,e9021b38-0b3c-484f-af2c-b36bbf765f85.jpg,Airplane,1147,1247,1711,1821,100,110
628,2560,2560,JPEG,RGB,False,1,e9021b38-0b3c-484f-af2c-b36bbf765f85.jpg,Airplane,1027,1128,1746,1862,101,116
629,2560,2560,JPEG,RGB,False,1,cbd51501-ed0f-411c-b472-df4357cca40c.jpg,Airplane,2327,2424,2352,2420,97,68
630,2560,2560,JPEG,RGB,False,1,cbd51501-ed0f-411c-b472-df4357cca40c.jpg,Airplane,2286,2350,2313,2372,64,59
631,2560,2560,JPEG,RGB,False,1,cbd51501-ed0f-411c-b472-df4357cca40c.jpg,Airplane,2231,2317,2236,2290,86,54
632,2560,2560,JPEG,RGB,False,1,cbd51501-ed0f-411c-b472-df4357cca40c.jpg,Airplane,2179,2272,2172,2234,93,62
633,2560,2560,JPEG,RGB,False,1,cbd51501-ed0f-411c-b472-df4357cca40c.jpg,Airplane,2124,2188,2118,2190,64,72
634,2560,2560,JPEG,RGB,False,1,cbd51501-ed0f-411c-b472-df4357cca40c.jpg,Airplane,2066,2134,2062,2146,68,84
635,2560,2560,JPEG,RGB,False,1,cbd51501-ed0f-411c-b472-df4357cca40c.jpg,Airplane,2005,2076,1997,2083,71,86
636,2560,2560,JPEG,RGB,False,1,cbd51501-ed0f-411c-b472-df4357cca40c.jpg,Airplane,1926,1988,1974,2058,62,84
637,2560,2560,JPEG,RGB,False,1,cbd51501-ed0f-411c-b472-df4357cca40c.jpg,Airplane,1838,1906,1972,2043,68,71
638,2560,2560,JPEG,RGB,False,1,cbd51501-ed0f-411c-b472-df4357cca40c.jpg,Airplane,1734,1800,1947,2036,66,89
639,2560,2560,JPEG,RGB,False,1,cbd51501-ed0f-411c-b472-df4357cca40c.jpg,Airplane,2133,2213,1909,1977,80,68
640,2560,2560,JPEG,RGB,False,1,cbd51501-ed0f-411c-b472-df4357cca40c.jpg,Airplane,1623,1698,1708,1783,75,75
641,2560,2560,JPEG,RGB,False,1,cbd51501-ed0f-411c-b472-df4357cca40c.jpg,Airplane,1720,1790,1716,1799,70,83
642,2560,2560,JPEG,RGB,False,1,cbd51501-ed0f-411c-b472-df4357cca40c.jpg,Airplane,1798,1868,1695,1766,70,71
643,2560,2560,JPEG,RGB,False,1,cbd51501-ed0f-411c-b472-df4357cca40c.jpg,Airplane,1893,1962,1699,1774,69,75
644,2560,2560,JPEG,RGB,False,1,cbd51501-ed0f-411c-b472-df4357cca40c.jpg,Airplane,1989,2053,1697,1766,64,69
645,2560,2560,JPEG,RGB,False,1,cbd51501-ed0f-411c-b472-df4357cca40c.jpg,Airplane,2078,2157,1645,1741,79,96
646,2560,2560,JPEG,RGB,False,1,cbd51501-ed0f-411c-b472-df4357cca40c.jpg,Airplane,2162,2222,1598,1670,60,72
647,2560,2560,JPEG,RGB,False,1,cbd51501-ed0f-411c-b472-df4357cca40c.jpg,Airplane,2418,2485,1636,1723,67,87
648,2560,2560,JPEG,RGB,False,1,cbd51501-ed0f-411c-b472-df4357cca40c.jpg,Airplane,2465,2537,1572,1641,72,69
649,2560,2560,JPEG,RGB,False,1,cbd51501-ed0f-411c-b472-df4357cca40c.jpg,Airplane,2231,2309,1443,1498,78,55
650,2560,2560,JPEG,RGB,False,1,cbd51501-ed0f-411c-b472-df4357cca40c.jpg,Airplane,2262,2355,1347,1419,93,72
651,2560,2560,JPEG,RGB,False,1,cbd51501-ed0f-411c-b472-df4357cca40c.jpg,Airplane,2312,2441,953,1049,129,96
652,2560,2560,JPEG,RGB,False,1,cbd51501-ed0f-411c-b472-df4357cca40c.jpg,Airplane,2325,2417,870,938,92,68
653,2560,2560,JPEG,RGB,False,1,cbd51501-ed0f-411c-b472-df4357cca40c.jpg,Airplane,2296,2384,794,856,88,62
654,2560,2560,JPEG,RGB,False,1,cbd51501-ed0f-411c-b472-df4357cca40c.jpg,Airplane,2322,2407,685,755,85,70
655,2560,2560,JPEG,RGB,False,1,cbd51501-ed0f-411c-b472-df4357cca40c.jpg,Airplane,2239,2314,643,712,75,69
656,2560,2560,JPEG,RGB,False,1,cbd51501-ed0f-411c-b472-df4357cca40c.jpg,Airplane,2186,2260,578,653,74,75
657,2560,2560,JPEG,RGB,False,1,cbd51501-ed0f-411c-b472-df4357cca40c.jpg,Airplane,2115,2190,512,582,75,70
658,2560,2560,JPEG,RGB,False,1,cbd51501-ed0f-411c-b472-df4357cca40c.jpg,Airplane,2052,2123,439,524,71,85
659,2560,2560,JPEG,RGB,False,1,cbd51501-ed0f-411c-b472-df4357cca40c.jpg,Airplane,1955,2048,398,498,93,100
660,2560,2560,JPEG,RGB,False,1,cbd51501-ed0f-411c-b472-df4357cca40c.jpg,Airplane,1859,1931,414,495,72,81
661,2560,2560,JPEG,RGB,False,1,cbd51501-ed0f-411c-b472-df4357cca40c.jpg,Airplane,1789,1848,420,488,59,68
662,2560,2560,JPEG,RGB,False,1,cbd51501-ed0f-411c-b472-df4357cca40c.jpg,Airplane,1710,1800,270,339,90,69
663,2560,2560,JPEG,RGB,False,1,cbd51501-ed0f-411c-b472-df4357cca40c.jpg,Airplane,1623,1698,341,416,75,75
664,2560,2560,JPEG,RGB,False,1,cbd51501-ed0f-411c-b472-df4357cca40c.jpg,Airplane,988,1054,2072,2150,66,78
665,2560,2560,JPEG,RGB,False,1,cbd51501-ed0f-411c-b472-df4357cca40c.jpg,Airplane,908,979,2052,2133,71,81
666,2560,2560,JPEG,RGB,False,1,cbd51501-ed0f-411c-b472-df4357cca40c.jpg,Airplane,821,890,2072,2153,69,81
667,2560,2560,JPEG,RGB,False,1,cbd51501-ed0f-411c-b472-df4357cca40c.jpg,Airplane,726,790,2053,2133,64,80
668,2560,2560,JPEG,RGB,False,1,cbd51501-ed0f-411c-b472-df4357cca40c.jpg,Airplane,617,689,2062,2148,72,86
669,2560,2560,JPEG,RGB,False,1,cbd51501-ed0f-411c-b472-df4357cca40c.jpg,Airplane,481,607,2029,2160,126,131
670,2560,2560,JPEG,RGB,False,1,cbd51501-ed0f-411c-b472-df4357cca40c.jpg,Airplane,407,471,2063,2141,64,78
671,2560,2560,JPEG,RGB,False,1,cbd51501-ed0f-411c-b472-df4357cca40c.jpg,Airplane,285,393,2020,2142,108,122
672,2560,2560,JPEG,RGB,False,1,cbd51501-ed0f-411c-b472-df4357cca40c.jpg,Airplane,159,233,1470,1517,74,47
673,2560,2560,JPEG,RGB,False,1,cbd51501-ed0f-411c-b472-df4357cca40c.jpg,Airplane,188,260,1540,1588,72,48
674,2560,2560,JPEG,RGB,False,1,cbd51501-ed0f-411c-b472-df4357cca40c.jpg,Airplane,225,289,1601,1655,64,54
675,2560,2560,JPEG,RGB,False,1,cbd51501-ed0f-411c-b472-df4357cca40c.jpg,Airplane,293,347,1641,1706,54,65
676,2560,2560,JPEG,RGB,False,1,cbd51501-ed0f-411c-b472-df4357cca40c.jpg,Airplane,950,1029,1910,1957,79,47
677,2560,2560,JPEG,RGB,False,1,cbd51501-ed0f-411c-b472-df4357cca40c.jpg,Airplane,936,1002,1849,1899,66,50
678,2560,2560,JPEG,RGB,False,1,cbd51501-ed0f-411c-b472-df4357cca40c.jpg,Airplane,971,1035,1785,1832,64,47
679,2560,2560,JPEG,RGB,False,1,cbd51501-ed0f-411c-b472-df4357cca40c.jpg,Airplane,879,940,1672,1739,61,67
680,2560,2560,JPEG,RGB,False,1,cbd51501-ed0f-411c-b472-df4357cca40c.jpg,Airplane,806,862,1661,1725,56,64
681,2560,2560,JPEG,RGB,False,1,cbd51501-ed0f-411c-b472-df4357cca40c.jpg,Airplane,742,795,1664,1730,53,66
682,2560,2560,JPEG,RGB,False,1,cbd51501-ed0f-411c-b472-df4357cca40c.jpg,Airplane,683,730,1664,1715,47,51
683,2560,2560,JPEG,RGB,False,1,cbd51501-ed0f-411c-b472-df4357cca40c.jpg,Airplane,516,572,1536,1588,56,52
684,2560,2560,JPEG,RGB,False,1,cbd51501-ed0f-411c-b472-df4357cca40c.jpg,Airplane,568,629,1580,1629,61,49
685,2560,2560,JPEG,RGB,False,1,cbd51501-ed0f-411c-b472-df4357cca40c.jpg,Airplane,630,685,1605,1665,55,60
686,2560,2560,JPEG,RGB,False,1,cbd51501-ed0f-411c-b472-df4357cca40c.jpg,Airplane,341,416,1194,1245,75,51
687,2560,2560,JPEG,RGB,False,1,cbd51501-ed0f-411c-b472-df4357cca40c.jpg,Airplane,310,383,1136,1183,73,47
688,2560,2560,JPEG,RGB,False,1,cbd51501-ed0f-411c-b472-df4357cca40c.jpg,Airplane,301,372,1067,1118,71,51
689,2560,2560,JPEG,RGB,False,1,cbd51501-ed0f-411c-b472-df4357cca40c.jpg,Airplane,325,402,1009,1057,77,48
690,2560,2560,JPEG,RGB,False,1,cbd51501-ed0f-411c-b472-df4357cca40c.jpg,Airplane,310,381,929,986,71,57
691,2560,2560,JPEG,RGB,False,1,cbd51501-ed0f-411c-b472-df4357cca40c.jpg,Airplane,138,205,890,937,67,47
692,2560,2560,JPEG,RGB,False,1,cbd51501-ed0f-411c-b472-df4357cca40c.jpg,Airplane,352,434,879,930,82,51
693,2560,2560,JPEG,RGB,False,1,cbd51501-ed0f-411c-b472-df4357cca40c.jpg,Airplane,367,450,827,872,83,45
694,2560,2560,JPEG,RGB,False,1,cbd51501-ed0f-411c-b472-df4357cca40c.jpg,Airplane,374,443,759,823,69,64
695,2560,2560,JPEG,RGB,False,1,cbd51501-ed0f-411c-b472-df4357cca40c.jpg,Airplane,417,475,713,771,58,58
696,2560,2560,JPEG,RGB,False,1,cbd51501-ed0f-411c-b472-df4357cca40c.jpg,Airplane,441,514,661,709,73,48
697,2560,2560,JPEG,RGB,False,1,cbd51501-ed0f-411c-b472-df4357cca40c.jpg,Airplane,461,524,592,634,63,42
698,2560,2560,JPEG,RGB,False,1,cbd51501-ed0f-411c-b472-df4357cca40c.jpg,Airplane,549,600,484,557,51,73
699,2560,2560,JPEG,RGB,False,1,cbd51501-ed0f-411c-b472-df4357cca40c.jpg,Airplane,609,663,461,524,54,63
700,2560,2560,JPEG,RGB,False,1,cbd51501-ed0f-411c-b472-df4357cca40c.jpg,Airplane,655,711,427,494,56,67
701,2560,2560,JPEG,RGB,False,1,cbd51501-ed0f-411c-b472-df4357cca40c.jpg,Airplane,719,762,401,469,43,68
702,2560,2560,JPEG,RGB,False,1,cbd51501-ed0f-411c-b472-df4357cca40c.jpg,Airplane,788,833,382,452,45,70
703,2560,2560,JPEG,RGB,False,1,cbd51501-ed0f-411c-b472-df4357cca40c.jpg,Airplane,858,905,368,435,47,67
704,2560,2560,JPEG,RGB,False,1,cbd51501-ed0f-411c-b472-df4357cca40c.jpg,Airplane,993,1040,358,424,47,66
705,2560,2560,JPEG,RGB,False,1,cbd51501-ed0f-411c-b472-df4357cca40c.jpg,Airplane,1061,1105,344,406,44,62
706,2560,2560,JPEG,RGB,False,1,cbd51501-ed0f-411c-b472-df4357cca40c.jpg,Airplane,928,989,272,330,61,58
707,2560,2560,JPEG,RGB,False,1,cbd51501-ed0f-411c-b472-df4357cca40c.jpg,Airplane,532,577,221,281,45,60
708,2560,2560,JPEG,RGB,False,1,cbd51501-ed0f-411c-b472-df4357cca40c.jpg,Airplane,497,538,415,485,41,70
709,2560,2560,JPEG,RGB,False,1,cbd51501-ed0f-411c-b472-df4357cca40c.jpg,Airplane,444,488,416,479,44,63
710,2560,2560,JPEG,RGB,False,1,cbd51501-ed0f-411c-b472-df4357cca40c.jpg,Airplane,396,438,410,473,42,63
711,2560,2560,JPEG,RGB,False,1,cbd51501-ed0f-411c-b472-df4357cca40c.jpg,Airplane,347,386,404,466,39,62
712,2560,2560,JPEG,RGB,False,1,cbd51501-ed0f-411c-b472-df4357cca40c.jpg,Airplane,284,330,414,468,46,54
713,2560,2560,JPEG,RGB,False,1,cbd51501-ed0f-411c-b472-df4357cca40c.jpg,Airplane,250,317,467,511,67,44
714,2560,2560,JPEG,RGB,False,1,cbd51501-ed0f-411c-b472-df4357cca40c.jpg,Airplane,240,297,521,561,57,40
715,2560,2560,JPEG,RGB,False,1,cbd51501-ed0f-411c-b472-df4357cca40c.jpg,Airplane,284,337,566,614,53,48
716,2560,2560,JPEG,RGB,False,1,cbd51501-ed0f-411c-b472-df4357cca40c.jpg,Airplane,355,414,581,621,59,40
717,2560,2560,JPEG,RGB,False,1,22457f2e-a740-4719-9512-056749695281.jpg,Airplane,463,637,1224,1371,174,147
718,2560,2560,JPEG,RGB,False,1,22457f2e-a740-4719-9512-056749695281.jpg,Airplane,904,1082,1258,1412,178,154
719,2560,2560,JPEG,RGB,False,1,22457f2e-a740-4719-9512-056749695281.jpg,Airplane,976,1140,1433,1546,164,113
720,2560,2560,JPEG,RGB,False,1,22457f2e-a740-4719-9512-056749695281.jpg,Airplane,1855,2043,1525,1697,188,172
721,2560,2560,JPEG,RGB,False,1,22457f2e-a740-4719-9512-056749695281.jpg,Airplane,782,959,944,1085,177,141
722,2560,2560,JPEG,RGB,False,1,22457f2e-a740-4719-9512-056749695281.jpg,Airplane,1571,1773,975,1162,202,187
723,2560,2560,JPEG,RGB,False,1,22457f2e-a740-4719-9512-056749695281.jpg,Airplane,2077,2294,756,903,217,147
724,2560,2560,JPEG,RGB,False,1,9089631b-b1c0-4df8-b3f4-061c98149a94.jpg,Airplane,1910,1995,156,240,85,84
725,2560,2560,JPEG,RGB,False,1,9089631b-b1c0-4df8-b3f4-061c98149a94.jpg,Airplane,2129,2203,587,673,74,86
726,2560,2560,JPEG,RGB,False,1,9089631b-b1c0-4df8-b3f4-061c98149a94.jpg,Airplane,1725,1802,337,441,77,104
727,2560,2560,JPEG,RGB,False,1,9089631b-b1c0-4df8-b3f4-061c98149a94.jpg,Airplane,1820,1891,397,493,71,96
728,2560,2560,JPEG,RGB,False,1,9089631b-b1c0-4df8-b3f4-061c98149a94.jpg,Airplane,1918,1979,462,536,61,74
729,2560,2560,JPEG,RGB,False,1,9089631b-b1c0-4df8-b3f4-061c98149a94.jpg,Airplane,386,539,934,1058,153,124
730,2560,2560,JPEG,RGB,False,1,9089631b-b1c0-4df8-b3f4-061c98149a94.jpg,Airplane,455,605,799,922,150,123
731,2560,2560,JPEG,RGB,False,1,9089631b-b1c0-4df8-b3f4-061c98149a94.jpg,Airplane,863,1012,650,784,149,134
732,2560,2560,JPEG,RGB,False,1,9089631b-b1c0-4df8-b3f4-061c98149a94.jpg,Airplane,795,932,792,922,137,130
733,2560,2560,JPEG,RGB,False,1,9089631b-b1c0-4df8-b3f4-061c98149a94.jpg,Airplane,1374,1453,663,737,79,74
734,2560,2560,JPEG,RGB,False,1,9089631b-b1c0-4df8-b3f4-061c98149a94.jpg,Airplane,1363,1450,758,826,87,68
735,2560,2560,JPEG,RGB,False,1,9089631b-b1c0-4df8-b3f4-061c98149a94.jpg,Airplane,1290,1355,816,886,65,70
736,2560,2560,JPEG,RGB,False,1,9089631b-b1c0-4df8-b3f4-061c98149a94.jpg,Airplane,1223,1300,873,942,77,69
737,2560,2560,JPEG,RGB,False,1,9089631b-b1c0-4df8-b3f4-061c98149a94.jpg,Airplane,1187,1267,949,1021,80,72
738,2560,2560,JPEG,RGB,False,1,9089631b-b1c0-4df8-b3f4-061c98149a94.jpg,Airplane,1220,1301,1027,1098,81,71
739,2560,2560,JPEG,RGB,False,1,9089631b-b1c0-4df8-b3f4-061c98149a94.jpg,Airplane,635,797,1081,1218,162,137
740,2560,2560,JPEG,RGB,False,1,9089631b-b1c0-4df8-b3f4-061c98149a94.jpg,Airplane,400,487,1317,1398,87,81
741,2560,2560,JPEG,RGB,False,1,9089631b-b1c0-4df8-b3f4-061c98149a94.jpg,Airplane,1079,1160,1589,1658,81,69
742,2560,2560,JPEG,RGB,False,1,9089631b-b1c0-4df8-b3f4-061c98149a94.jpg,Airplane,1745,1808,1352,1442,63,90
743,2560,2560,JPEG,RGB,False,1,9089631b-b1c0-4df8-b3f4-061c98149a94.jpg,Airplane,1785,1826,1625,1682,41,57
744,2560,2560,JPEG,RGB,False,1,9089631b-b1c0-4df8-b3f4-061c98149a94.jpg,Airplane,1592,1666,1560,1647,74,87
745,2560,2560,JPEG,RGB,False,1,9089631b-b1c0-4df8-b3f4-061c98149a94.jpg,Airplane,1301,1452,1699,1827,151,128
746,2560,2560,JPEG,RGB,False,1,9089631b-b1c0-4df8-b3f4-061c98149a94.jpg,Airplane,1183,1273,1843,1917,90,74
747,2560,2560,JPEG,RGB,False,1,9089631b-b1c0-4df8-b3f4-061c98149a94.jpg,Airplane,1592,1665,1928,2017,73,89
748,2560,2560,JPEG,RGB,False,1,9089631b-b1c0-4df8-b3f4-061c98149a94.jpg,Airplane,2034,2129,2205,2282,95,77
749,2560,2560,JPEG,RGB,False,1,9089631b-b1c0-4df8-b3f4-061c98149a94.jpg,Airplane,2267,2344,2220,2325,77,105
750,2560,2560,JPEG,RGB,False,1,9089631b-b1c0-4df8-b3f4-061c98149a94.jpg,Airplane,1904,1981,2361,2455,77,94
751,2560,2560,JPEG,RGB,False,1,9089631b-b1c0-4df8-b3f4-061c98149a94.jpg,Airplane,1763,1866,2425,2516,103,91
752,2560,2560,JPEG,RGB,False,1,9089631b-b1c0-4df8-b3f4-061c98149a94.jpg,Airplane,479,552,1181,1268,73,87
753,2560,2560,JPEG,RGB,False,1,9089631b-b1c0-4df8-b3f4-061c98149a94.jpg,Truncated_airplane,2276,2351,5,42,75,37
754,2560,2560,JPEG,RGB,False,1,3da0b873-fdde-4faf-9a85-021248c7dacf.jpg,Airplane,779,965,62,233,186,171
755,2560,2560,JPEG,RGB,False,1,3da0b873-fdde-4faf-9a85-021248c7dacf.jpg,Airplane,1519,1678,465,626,159,161
756,2560,2560,JPEG,RGB,False,1,3da0b873-fdde-4faf-9a85-021248c7dacf.jpg,Airplane,2066,2279,590,783,213,193
757,2560,2560,JPEG,RGB,False,1,3da0b873-fdde-4faf-9a85-021248c7dacf.jpg,Airplane,1048,1213,330,488,165,158
758,2560,2560,JPEG,RGB,False,1,3da0b873-fdde-4faf-9a85-021248c7dacf.jpg,Airplane,901,1076,504,663,175,159
759,2560,2560,JPEG,RGB,False,1,3da0b873-fdde-4faf-9a85-021248c7dacf.jpg,Airplane,577,766,447,639,189,192
760,2560,2560,JPEG,RGB,False,1,3da0b873-fdde-4faf-9a85-021248c7dacf.jpg,Airplane,801,969,676,826,168,150
761,2560,2560,JPEG,RGB,False,1,3da0b873-fdde-4faf-9a85-021248c7dacf.jpg,Airplane,726,886,858,1007,160,149
762,2560,2560,JPEG,RGB,False,1,3da0b873-fdde-4faf-9a85-021248c7dacf.jpg,Airplane,1154,1346,1019,1190,192,171
763,2560,2560,JPEG,RGB,False,1,3da0b873-fdde-4faf-9a85-021248c7dacf.jpg,Airplane,1707,1804,1069,1193,97,124
764,2560,2560,JPEG,RGB,False,1,3da0b873-fdde-4faf-9a85-021248c7dacf.jpg,Airplane,2219,2387,1473,1661,168,188
765,2560,2560,JPEG,RGB,False,1,3da0b873-fdde-4faf-9a85-021248c7dacf.jpg,Airplane,2043,2113,1856,1950,70,94
766,2560,2560,JPEG,RGB,False,1,3da0b873-fdde-4faf-9a85-021248c7dacf.jpg,Airplane,1785,1886,1833,1938,101,105
767,2560,2560,JPEG,RGB,False,1,3da0b873-fdde-4faf-9a85-021248c7dacf.jpg,Airplane,1041,1214,1183,1333,173,150
768,2560,2560,JPEG,RGB,False,1,3da0b873-fdde-4faf-9a85-021248c7dacf.jpg,Airplane,1015,1114,1363,1455,99,92
769,2560,2560,JPEG,RGB,False,1,3da0b873-fdde-4faf-9a85-021248c7dacf.jpg,Airplane,1207,1371,1391,1559,164,168
770,2560,2560,JPEG,RGB,False,1,3da0b873-fdde-4faf-9a85-021248c7dacf.jpg,Airplane,1405,1565,1556,1717,160,161
771,2560,2560,JPEG,RGB,False,1,3da0b873-fdde-4faf-9a85-021248c7dacf.jpg,Airplane,1350,1456,1720,1839,106,119
772,2560,2560,JPEG,RGB,False,1,3da0b873-fdde-4faf-9a85-021248c7dacf.jpg,Airplane,1159,1329,1745,1922,170,177
773,2560,2560,JPEG,RGB,False,1,3da0b873-fdde-4faf-9a85-021248c7dacf.jpg,Airplane,857,1028,1718,1902,171,184
774,2560,2560,JPEG,RGB,False,1,3da0b873-fdde-4faf-9a85-021248c7dacf.jpg,Airplane,632,809,1042,1195,177,153
775,2560,2560,JPEG,RGB,False,1,3da0b873-fdde-4faf-9a85-021248c7dacf.jpg,Airplane,542,701,1198,1345,159,147
776,2560,2560,JPEG,RGB,False,1,3da0b873-fdde-4faf-9a85-021248c7dacf.jpg,Airplane,2246,2342,2169,2288,96,119
777,2560,2560,JPEG,RGB,False,1,3da0b873-fdde-4faf-9a85-021248c7dacf.jpg,Airplane,2006,2107,2152,2267,101,115
778,2560,2560,JPEG,RGB,False,1,3da0b873-fdde-4faf-9a85-021248c7dacf.jpg,Airplane,1156,1292,2110,2268,136,158
779,2560,2560,JPEG,RGB,False,1,3da0b873-fdde-4faf-9a85-021248c7dacf.jpg,Airplane,1327,1424,2217,2313,97,96
780,2560,2560,JPEG,RGB,False,1,3da0b873-fdde-4faf-9a85-021248c7dacf.jpg,Airplane,745,819,2080,2188,74,108
781,2560,2560,JPEG,RGB,False,1,3da0b873-fdde-4faf-9a85-021248c7dacf.jpg,Airplane,1022,1125,2133,2245,103,112
782,2560,2560,JPEG,RGB,False,1,3da0b873-fdde-4faf-9a85-021248c7dacf.jpg,Airplane,6,177,349,525,171,176
783,2560,2560,JPEG,RGB,False,1,3da0b873-fdde-4faf-9a85-021248c7dacf.jpg,Airplane,223,407,325,529,184,204
784,2560,2560,JPEG,RGB,False,1,af67041b-f363-47ae-8ddd-f652db3a6bab.jpg,Airplane,2361,2489,939,1074,128,135
785,2560,2560,JPEG,RGB,False,1,af67041b-f363-47ae-8ddd-f652db3a6bab.jpg,Airplane,1947,2065,1116,1232,118,116
786,2560,2560,JPEG,RGB,False,1,af67041b-f363-47ae-8ddd-f652db3a6bab.jpg,Airplane,1334,1414,944,1038,80,94
787,2560,2560,JPEG,RGB,False,1,af67041b-f363-47ae-8ddd-f652db3a6bab.jpg,Airplane,1643,1732,1170,1237,89,67
788,2560,2560,JPEG,RGB,False,1,af67041b-f363-47ae-8ddd-f652db3a6bab.jpg,Airplane,1651,1736,791,849,85,58
789,2560,2560,JPEG,RGB,False,1,af67041b-f363-47ae-8ddd-f652db3a6bab.jpg,Airplane,1610,1754,1405,1533,144,128
790,2560,2560,JPEG,RGB,False,1,af67041b-f363-47ae-8ddd-f652db3a6bab.jpg,Airplane,1651,1738,1699,1774,87,75
791,2560,2560,JPEG,RGB,False,1,af67041b-f363-47ae-8ddd-f652db3a6bab.jpg,Airplane,1203,1254,1388,1429,51,41
792,2560,2560,JPEG,RGB,False,1,af67041b-f363-47ae-8ddd-f652db3a6bab.jpg,Airplane,1213,1283,1625,1679,70,54
793,2560,2560,JPEG,RGB,False,1,af67041b-f363-47ae-8ddd-f652db3a6bab.jpg,Airplane,1215,1276,1711,1757,61,46
794,2560,2560,JPEG,RGB,False,1,af67041b-f363-47ae-8ddd-f652db3a6bab.jpg,Airplane,1213,1276,1781,1832,63,51
795,2560,2560,JPEG,RGB,False,1,af67041b-f363-47ae-8ddd-f652db3a6bab.jpg,Airplane,1198,1275,1933,2006,77,73
796,2560,2560,JPEG,RGB,False,1,af67041b-f363-47ae-8ddd-f652db3a6bab.jpg,Airplane,1177,1261,2019,2089,84,70
797,2560,2560,JPEG,RGB,False,1,af67041b-f363-47ae-8ddd-f652db3a6bab.jpg,Airplane,987,1064,1923,1996,77,73
798,2560,2560,JPEG,RGB,False,1,af67041b-f363-47ae-8ddd-f652db3a6bab.jpg,Airplane,1006,1071,1764,1805,65,41
799,2560,2560,JPEG,RGB,False,1,af67041b-f363-47ae-8ddd-f652db3a6bab.jpg,Airplane,859,925,1194,1243,66,49
800,2560,2560,JPEG,RGB,False,1,af67041b-f363-47ae-8ddd-f652db3a6bab.jpg,Airplane,566,636,1995,2063,70,68
801,2560,2560,JPEG,RGB,False,1,af67041b-f363-47ae-8ddd-f652db3a6bab.jpg,Airplane,987,1047,987,1041,60,54
802,2560,2560,JPEG,RGB,False,1,af67041b-f363-47ae-8ddd-f652db3a6bab.jpg,Airplane,1218,1276,665,711,58,46
803,2560,2560,JPEG,RGB,False,1,af67041b-f363-47ae-8ddd-f652db3a6bab.jpg,Airplane,1204,1264,778,829,60,51
804,2560,2560,JPEG,RGB,False,1,af67041b-f363-47ae-8ddd-f652db3a6bab.jpg,Airplane,1225,1281,833,886,56,53
805,2560,2560,JPEG,RGB,False,1,af67041b-f363-47ae-8ddd-f652db3a6bab.jpg,Airplane,978,1041,809,862,63,53
806,2560,2560,JPEG,RGB,False,1,af67041b-f363-47ae-8ddd-f652db3a6bab.jpg,Airplane,984,1046,871,922,62,51
807,2560,2560,JPEG,RGB,False,1,af67041b-f363-47ae-8ddd-f652db3a6bab.jpg,Airplane,162,247,434,507,85,73
808,2560,2560,JPEG,RGB,False,1,af67041b-f363-47ae-8ddd-f652db3a6bab.jpg,Airplane,741,821,984,1058,80,74
809,2560,2560,JPEG,RGB,False,1,af67041b-f363-47ae-8ddd-f652db3a6bab.jpg,Airplane,244,311,1911,2012,67,101
810,2560,2560,JPEG,RGB,False,1,af67041b-f363-47ae-8ddd-f652db3a6bab.jpg,Airplane,596,671,1660,1737,75,77
811,2560,2560,JPEG,RGB,False,1,af67041b-f363-47ae-8ddd-f652db3a6bab.jpg,Airplane,589,674,1754,1815,85,61
812,2560,2560,JPEG,RGB,False,1,af67041b-f363-47ae-8ddd-f652db3a6bab.jpg,Airplane,369,463,1733,1816,94,83
813,2560,2560,JPEG,RGB,False,1,af67041b-f363-47ae-8ddd-f652db3a6bab.jpg,Airplane,580,667,604,679,87,75
814,2560,2560,JPEG,RGB,False,1,af67041b-f363-47ae-8ddd-f652db3a6bab.jpg,Airplane,611,693,766,836,82,70
815,2560,2560,JPEG,RGB,False,1,af67041b-f363-47ae-8ddd-f652db3a6bab.jpg,Airplane,602,679,932,997,77,65
816,2560,2560,JPEG,RGB,False,1,af67041b-f363-47ae-8ddd-f652db3a6bab.jpg,Airplane,601,686,1088,1151,85,63
817,2560,2560,JPEG,RGB,False,1,af67041b-f363-47ae-8ddd-f652db3a6bab.jpg,Airplane,609,688,1165,1237,79,72
818,2560,2560,JPEG,RGB,False,1,af67041b-f363-47ae-8ddd-f652db3a6bab.jpg,Airplane,352,448,775,843,96,68
819,2560,2560,JPEG,RGB,False,1,af67041b-f363-47ae-8ddd-f652db3a6bab.jpg,Airplane,351,443,1027,1095,92,68
820,2560,2560,JPEG,RGB,False,1,af67041b-f363-47ae-8ddd-f652db3a6bab.jpg,Airplane,357,451,1103,1168,94,65
821,2560,2560,JPEG,RGB,False,1,af67041b-f363-47ae-8ddd-f652db3a6bab.jpg,Truncated_airplane,3,73,592,665,70,73
822,2560,2560,JPEG,RGB,False,1,af67041b-f363-47ae-8ddd-f652db3a6bab.jpg,Truncated_airplane,1,66,684,756,65,72
823,2560,2560,JPEG,RGB,False,1,af67041b-f363-47ae-8ddd-f652db3a6bab.jpg,Truncated_airplane,0,66,763,852,66,89
824,2560,2560,JPEG,RGB,False,1,af67041b-f363-47ae-8ddd-f652db3a6bab.jpg,Truncated_airplane,0,80,1047,1130,80,83
825,2560,2560,JPEG,RGB,False,1,af67041b-f363-47ae-8ddd-f652db3a6bab.jpg,Truncated_airplane,0,82,1148,1216,82,68
826,2560,2560,JPEG,RGB,False,1,af67041b-f363-47ae-8ddd-f652db3a6bab.jpg,Truncated_airplane,0,80,1223,1295,80,72
827,2560,2560,JPEG,RGB,False,1,af67041b-f363-47ae-8ddd-f652db3a6bab.jpg,Truncated_airplane,0,63,1355,1435,63,80
828,2560,2560,JPEG,RGB,False,1,af67041b-f363-47ae-8ddd-f652db3a6bab.jpg,Truncated_airplane,0,58,1447,1526,58,79
829,2560,2560,JPEG,RGB,False,1,af67041b-f363-47ae-8ddd-f652db3a6bab.jpg,Truncated_airplane,0,65,1536,1611,65,75
830,2560,2560,JPEG,RGB,False,1,af67041b-f363-47ae-8ddd-f652db3a6bab.jpg,Truncated_airplane,0,58,1624,1708,58,84
831,2560,2560,JPEG,RGB,False,1,af67041b-f363-47ae-8ddd-f652db3a6bab.jpg,Truncated_airplane,0,66,1808,1895,66,87
832,2560,2560,JPEG,RGB,False,1,af67041b-f363-47ae-8ddd-f652db3a6bab.jpg,Truncated_airplane,0,72,1902,1985,72,83
833,2560,2560,JPEG,RGB,False,1,dce20c6a-d661-4258-9c58-5507f38ce97e.jpg,Airplane,891,994,638,741,103,103
834,2560,2560,JPEG,RGB,False,1,dce20c6a-d661-4258-9c58-5507f38ce97e.jpg,Airplane,564,687,587,692,123,105
835,2560,2560,JPEG,RGB,False,1,dce20c6a-d661-4258-9c58-5507f38ce97e.jpg,Airplane,523,664,710,819,141,109
836,2560,2560,JPEG,RGB,False,1,dce20c6a-d661-4258-9c58-5507f38ce97e.jpg,Airplane,805,935,880,996,130,116
837,2560,2560,JPEG,RGB,False,1,dce20c6a-d661-4258-9c58-5507f38ce97e.jpg,Airplane,458,565,1001,1137,107,136
838,2560,2560,JPEG,RGB,False,1,dce20c6a-d661-4258-9c58-5507f38ce97e.jpg,Airplane,694,754,1085,1159,60,74
839,2560,2560,JPEG,RGB,False,1,dce20c6a-d661-4258-9c58-5507f38ce97e.jpg,Airplane,387,492,1298,1420,105,122
840,2560,2560,JPEG,RGB,False,1,dce20c6a-d661-4258-9c58-5507f38ce97e.jpg,Airplane,630,686,1363,1438,56,75
841,2560,2560,JPEG,RGB,False,1,dce20c6a-d661-4258-9c58-5507f38ce97e.jpg,Airplane,687,763,1521,1581,76,60
842,2560,2560,JPEG,RGB,False,1,dce20c6a-d661-4258-9c58-5507f38ce97e.jpg,Airplane,301,436,1586,1733,135,147
843,2560,2560,JPEG,RGB,False,1,dce20c6a-d661-4258-9c58-5507f38ce97e.jpg,Airplane,641,759,1618,1726,118,108
844,2560,2560,JPEG,RGB,False,1,dce20c6a-d661-4258-9c58-5507f38ce97e.jpg,Airplane,1202,1299,1499,1612,97,113
845,2560,2560,JPEG,RGB,False,1,dce20c6a-d661-4258-9c58-5507f38ce97e.jpg,Airplane,1456,1515,1578,1651,59,73
846,2560,2560,JPEG,RGB,False,1,dce20c6a-d661-4258-9c58-5507f38ce97e.jpg,Airplane,1721,1826,1625,1761,105,136
847,2560,2560,JPEG,RGB,False,1,dce20c6a-d661-4258-9c58-5507f38ce97e.jpg,Airplane,1590,1699,1593,1737,109,144
848,2560,2560,JPEG,RGB,False,1,dce20c6a-d661-4258-9c58-5507f38ce97e.jpg,Airplane,2014,2140,1832,1956,126,124
849,2560,2560,JPEG,RGB,False,1,dce20c6a-d661-4258-9c58-5507f38ce97e.jpg,Airplane,1822,1926,2096,2205,104,109
850,2560,2560,JPEG,RGB,False,1,dce20c6a-d661-4258-9c58-5507f38ce97e.jpg,Airplane,1326,1438,1698,1805,112,107
851,2560,2560,JPEG,RGB,False,1,dce20c6a-d661-4258-9c58-5507f38ce97e.jpg,Airplane,1329,1412,1828,1905,83,77
852,2560,2560,JPEG,RGB,False,1,dce20c6a-d661-4258-9c58-5507f38ce97e.jpg,Airplane,878,996,1826,1939,118,113
853,2560,2560,JPEG,RGB,False,1,dce20c6a-d661-4258-9c58-5507f38ce97e.jpg,Airplane,628,697,1771,1831,69,60
854,2560,2560,JPEG,RGB,False,1,dce20c6a-d661-4258-9c58-5507f38ce97e.jpg,Airplane,563,695,1871,1984,132,113
855,2560,2560,JPEG,RGB,False,1,dce20c6a-d661-4258-9c58-5507f38ce97e.jpg,Airplane,555,663,2012,2101,108,89
856,2560,2560,JPEG,RGB,False,1,dce20c6a-d661-4258-9c58-5507f38ce97e.jpg,Airplane,815,927,2081,2191,112,110
857,2560,2560,JPEG,RGB,False,1,dce20c6a-d661-4258-9c58-5507f38ce97e.jpg,Airplane,1246,1372,2049,2163,126,114
858,2560,2560,JPEG,RGB,False,1,dce20c6a-d661-4258-9c58-5507f38ce97e.jpg,Airplane,1483,1609,2251,2374,126,123
859,2560,2560,JPEG,RGB,False,1,dce20c6a-d661-4258-9c58-5507f38ce97e.jpg,Airplane,2308,2414,1924,2029,106,105
860,2560,2560,JPEG,RGB,False,1,dce20c6a-d661-4258-9c58-5507f38ce97e.jpg,Airplane,2452,2522,1831,1905,70,74
861,2560,2560,JPEG,RGB,False,1,dce20c6a-d661-4258-9c58-5507f38ce97e.jpg,Airplane,2270,2376,2058,2160,106,102
862,2560,2560,JPEG,RGB,False,1,dce20c6a-d661-4258-9c58-5507f38ce97e.jpg,Airplane,2233,2357,2176,2290,124,114
863,2560,2560,JPEG,RGB,False,1,dce20c6a-d661-4258-9c58-5507f38ce97e.jpg,Airplane,2197,2333,2307,2419,136,112
864,2560,2560,JPEG,RGB,False,1,dce20c6a-d661-4258-9c58-5507f38ce97e.jpg,Airplane,1879,2011,2350,2467,132,117
865,2560,2560,JPEG,RGB,False,1,dce20c6a-d661-4258-9c58-5507f38ce97e.jpg,Airplane,1988,2035,1731,1792,47,61
866,2560,2560,JPEG,RGB,False,1,dce20c6a-d661-4258-9c58-5507f38ce97e.jpg,Airplane,2477,2537,1347,1405,60,58
867,2560,2560,JPEG,RGB,False,1,dce20c6a-d661-4258-9c58-5507f38ce97e.jpg,Truncated_airplane,2480,2556,2424,2559,76,135
868,2560,2560,JPEG,RGB,False,1,03f84930-e2be-4c19-9afc-0dc26d02538e.jpg,Airplane,1713,1813,968,1087,100,119
869,2560,2560,JPEG,RGB,False,1,03f84930-e2be-4c19-9afc-0dc26d02538e.jpg,Airplane,2077,2138,1175,1244,61,69
870,2560,2560,JPEG,RGB,False,1,03f84930-e2be-4c19-9afc-0dc26d02538e.jpg,Airplane,864,999,1015,1134,135,119
871,2560,2560,JPEG,RGB,False,1,03f84930-e2be-4c19-9afc-0dc26d02538e.jpg,Airplane,641,709,1230,1284,68,54
872,2560,2560,JPEG,RGB,False,1,03f84930-e2be-4c19-9afc-0dc26d02538e.jpg,Airplane,744,846,1336,1441,102,105
873,2560,2560,JPEG,RGB,False,1,03f84930-e2be-4c19-9afc-0dc26d02538e.jpg,Airplane,1018,1084,1261,1327,66,66
874,2560,2560,JPEG,RGB,False,1,03f84930-e2be-4c19-9afc-0dc26d02538e.jpg,Airplane,1186,1248,1338,1411,62,73
875,2560,2560,JPEG,RGB,False,1,03f84930-e2be-4c19-9afc-0dc26d02538e.jpg,Airplane,1359,1432,1407,1483,73,76
876,2560,2560,JPEG,RGB,False,1,03f84930-e2be-4c19-9afc-0dc26d02538e.jpg,Airplane,1457,1561,1442,1592,104,150
877,2560,2560,JPEG,RGB,False,1,03f84930-e2be-4c19-9afc-0dc26d02538e.jpg,Airplane,1565,1630,1610,1672,65,62
878,2560,2560,JPEG,RGB,False,1,03f84930-e2be-4c19-9afc-0dc26d02538e.jpg,Airplane,1666,1726,1593,1668,60,75
879,2560,2560,JPEG,RGB,False,1,03f84930-e2be-4c19-9afc-0dc26d02538e.jpg,Airplane,1879,1935,1751,1817,56,66
880,2560,2560,JPEG,RGB,False,1,03f84930-e2be-4c19-9afc-0dc26d02538e.jpg,Airplane,2060,2126,1634,1702,66,68
881,2560,2560,JPEG,RGB,False,1,03f84930-e2be-4c19-9afc-0dc26d02538e.jpg,Airplane,2109,2166,1882,1947,57,65
882,2560,2560,JPEG,RGB,False,1,03f84930-e2be-4c19-9afc-0dc26d02538e.jpg,Airplane,2222,2286,1957,2024,64,67
883,2560,2560,JPEG,RGB,False,1,03f84930-e2be-4c19-9afc-0dc26d02538e.jpg,Airplane,2331,2411,2012,2075,80,63
884,2560,2560,JPEG,RGB,False,1,03f84930-e2be-4c19-9afc-0dc26d02538e.jpg,Airplane,2305,2421,2122,2232,116,110
885,2560,2560,JPEG,RGB,False,1,03f84930-e2be-4c19-9afc-0dc26d02538e.jpg,Airplane,2164,2297,2361,2478,133,117
886,2560,2560,JPEG,RGB,False,1,03f84930-e2be-4c19-9afc-0dc26d02538e.jpg,Airplane,860,976,1446,1553,116,107
887,2560,2560,JPEG,RGB,False,1,03f84930-e2be-4c19-9afc-0dc26d02538e.jpg,Airplane,1600,1632,150,189,32,39
888,2560,2560,JPEG,RGB,False,1,14436c8c-93ec-41af-9fbf-43a5f39f2b98.jpg,Airplane,16,150,854,995,134,141
889,2560,2560,JPEG,RGB,False,1,14436c8c-93ec-41af-9fbf-43a5f39f2b98.jpg,Airplane,2232,2357,356,477,125,121
890,2560,2560,JPEG,RGB,False,1,14436c8c-93ec-41af-9fbf-43a5f39f2b98.jpg,Airplane,2319,2439,606,719,120,113
891,2560,2560,JPEG,RGB,False,1,14436c8c-93ec-41af-9fbf-43a5f39f2b98.jpg,Airplane,2364,2487,738,853,123,115
892,2560,2560,JPEG,RGB,False,1,14436c8c-93ec-41af-9fbf-43a5f39f2b98.jpg,Airplane,1967,2045,570,635,78,65
893,2560,2560,JPEG,RGB,False,1,14436c8c-93ec-41af-9fbf-43a5f39f2b98.jpg,Airplane,1996,2069,646,711,73,65
894,2560,2560,JPEG,RGB,False,1,14436c8c-93ec-41af-9fbf-43a5f39f2b98.jpg,Airplane,1968,2033,850,921,65,71
895,2560,2560,JPEG,RGB,False,1,14436c8c-93ec-41af-9fbf-43a5f39f2b98.jpg,Airplane,1720,1815,661,737,95,76
896,2560,2560,JPEG,RGB,False,1,14436c8c-93ec-41af-9fbf-43a5f39f2b98.jpg,Airplane,1760,1840,744,805,80,61
897,2560,2560,JPEG,RGB,False,1,14436c8c-93ec-41af-9fbf-43a5f39f2b98.jpg,Airplane,1809,1874,897,979,65,82
898,2560,2560,JPEG,RGB,False,1,14436c8c-93ec-41af-9fbf-43a5f39f2b98.jpg,Airplane,2020,2102,965,1039,82,74
899,2560,2560,JPEG,RGB,False,1,14436c8c-93ec-41af-9fbf-43a5f39f2b98.jpg,Airplane,2318,2450,903,1017,132,114
900,2560,2560,JPEG,RGB,False,1,14436c8c-93ec-41af-9fbf-43a5f39f2b98.jpg,Airplane,1168,1284,848,987,116,139
901,2560,2560,JPEG,RGB,False,1,14436c8c-93ec-41af-9fbf-43a5f39f2b98.jpg,Airplane,2304,2379,1048,1133,75,85
902,2560,2560,JPEG,RGB,False,1,14436c8c-93ec-41af-9fbf-43a5f39f2b98.jpg,Airplane,2061,2171,1116,1246,110,130
903,2560,2560,JPEG,RGB,False,1,14436c8c-93ec-41af-9fbf-43a5f39f2b98.jpg,Airplane,1814,1924,1196,1332,110,136
904,2560,2560,JPEG,RGB,False,1,14436c8c-93ec-41af-9fbf-43a5f39f2b98.jpg,Airplane,1175,1311,1040,1167,136,127
905,2560,2560,JPEG,RGB,False,1,14436c8c-93ec-41af-9fbf-43a5f39f2b98.jpg,Airplane,1383,1515,1133,1252,132,119
906,2560,2560,JPEG,RGB,False,1,14436c8c-93ec-41af-9fbf-43a5f39f2b98.jpg,Airplane,1549,1666,1272,1424,117,152
907,2560,2560,JPEG,RGB,False,1,14436c8c-93ec-41af-9fbf-43a5f39f2b98.jpg,Airplane,1422,1539,1314,1467,117,153
908,2560,2560,JPEG,RGB,False,1,14436c8c-93ec-41af-9fbf-43a5f39f2b98.jpg,Airplane,716,777,1045,1123,61,78
909,2560,2560,JPEG,RGB,False,1,14436c8c-93ec-41af-9fbf-43a5f39f2b98.jpg,Airplane,492,612,1051,1166,120,115
910,2560,2560,JPEG,RGB,False,1,14436c8c-93ec-41af-9fbf-43a5f39f2b98.jpg,Airplane,335,414,1143,1219,79,76
911,2560,2560,JPEG,RGB,False,1,14436c8c-93ec-41af-9fbf-43a5f39f2b98.jpg,Airplane,936,1042,1469,1593,106,124
912,2560,2560,JPEG,RGB,False,1,14436c8c-93ec-41af-9fbf-43a5f39f2b98.jpg,Airplane,818,924,1409,1536,106,127
913,2560,2560,JPEG,RGB,False,1,14436c8c-93ec-41af-9fbf-43a5f39f2b98.jpg,Airplane,698,808,1356,1476,110,120
914,2560,2560,JPEG,RGB,False,1,14436c8c-93ec-41af-9fbf-43a5f39f2b98.jpg,Airplane,586,688,1298,1420,102,122
915,2560,2560,JPEG,RGB,False,1,14436c8c-93ec-41af-9fbf-43a5f39f2b98.jpg,Airplane,458,578,1253,1372,120,119
916,2560,2560,JPEG,RGB,False,1,14436c8c-93ec-41af-9fbf-43a5f39f2b98.jpg,Airplane,2180,2299,1381,1514,119,133
917,2560,2560,JPEG,RGB,False,1,14436c8c-93ec-41af-9fbf-43a5f39f2b98.jpg,Airplane,2062,2171,1429,1550,109,121
918,2560,2560,JPEG,RGB,False,1,14436c8c-93ec-41af-9fbf-43a5f39f2b98.jpg,Airplane,1901,2004,1484,1603,103,119
919,2560,2560,JPEG,RGB,False,1,14436c8c-93ec-41af-9fbf-43a5f39f2b98.jpg,Airplane,1806,1867,1537,1614,61,77
920,2560,2560,JPEG,RGB,False,1,14436c8c-93ec-41af-9fbf-43a5f39f2b98.jpg,Airplane,1648,1755,1570,1688,107,118
921,2560,2560,JPEG,RGB,False,1,14436c8c-93ec-41af-9fbf-43a5f39f2b98.jpg,Airplane,1730,1806,1935,2006,76,71
922,2560,2560,JPEG,RGB,False,1,14436c8c-93ec-41af-9fbf-43a5f39f2b98.jpg,Airplane,1387,1506,1789,1889,119,100
923,2560,2560,JPEG,RGB,False,1,14436c8c-93ec-41af-9fbf-43a5f39f2b98.jpg,Airplane,1332,1448,1917,2017,116,100
924,2560,2560,JPEG,RGB,False,1,14436c8c-93ec-41af-9fbf-43a5f39f2b98.jpg,Airplane,1297,1380,2045,2109,83,64
925,2560,2560,JPEG,RGB,False,1,14436c8c-93ec-41af-9fbf-43a5f39f2b98.jpg,Airplane,1089,1221,1710,1830,132,120
926,2560,2560,JPEG,RGB,False,1,14436c8c-93ec-41af-9fbf-43a5f39f2b98.jpg,Airplane,1020,1167,1830,1948,147,118
927,2560,2560,JPEG,RGB,False,1,14436c8c-93ec-41af-9fbf-43a5f39f2b98.jpg,Airplane,985,1081,2002,2078,96,76
928,2560,2560,JPEG,RGB,False,1,14436c8c-93ec-41af-9fbf-43a5f39f2b98.jpg,Airplane,843,976,2211,2322,133,111
929,2560,2560,JPEG,RGB,False,1,14436c8c-93ec-41af-9fbf-43a5f39f2b98.jpg,Airplane,793,918,2331,2440,125,109
930,2560,2560,JPEG,RGB,False,1,14436c8c-93ec-41af-9fbf-43a5f39f2b98.jpg,Airplane,775,869,1744,1817,94,73
931,2560,2560,JPEG,RGB,False,1,14436c8c-93ec-41af-9fbf-43a5f39f2b98.jpg,Airplane,404,481,1565,1644,77,79
932,2560,2560,JPEG,RGB,False,1,14436c8c-93ec-41af-9fbf-43a5f39f2b98.jpg,Airplane,508,575,1631,1710,67,79
933,2560,2560,JPEG,RGB,False,1,14436c8c-93ec-41af-9fbf-43a5f39f2b98.jpg,Airplane,727,814,1839,1900,87,61
934,2560,2560,JPEG,RGB,False,1,14436c8c-93ec-41af-9fbf-43a5f39f2b98.jpg,Airplane,640,723,2017,2081,83,64
935,2560,2560,JPEG,RGB,False,1,14436c8c-93ec-41af-9fbf-43a5f39f2b98.jpg,Airplane,609,671,2174,2231,62,57
936,2560,2560,JPEG,RGB,False,1,14436c8c-93ec-41af-9fbf-43a5f39f2b98.jpg,Airplane,26,130,1543,1618,104,75
937,2560,2560,JPEG,RGB,False,1,14436c8c-93ec-41af-9fbf-43a5f39f2b98.jpg,Airplane,65,140,1626,1698,75,72
938,2560,2560,JPEG,RGB,False,1,14436c8c-93ec-41af-9fbf-43a5f39f2b98.jpg,Airplane,90,163,1704,1769,73,65
939,2560,2560,JPEG,RGB,False,1,14436c8c-93ec-41af-9fbf-43a5f39f2b98.jpg,Airplane,127,208,1858,1927,81,69
940,2560,2560,JPEG,RGB,False,1,14436c8c-93ec-41af-9fbf-43a5f39f2b98.jpg,Truncated_airplane,2496,2559,1398,1496,63,98
941,2560,2560,JPEG,RGB,False,1,14436c8c-93ec-41af-9fbf-43a5f39f2b98.jpg,Truncated_airplane,0,59,2383,2471,59,88
942,2560,2560,JPEG,RGB,False,1,7ab2461e-fad4-4d90-a260-8317bbc4e958.jpg,Airplane,117,287,572,783,170,211
943,2560,2560,JPEG,RGB,False,1,7ab2461e-fad4-4d90-a260-8317bbc4e958.jpg,Airplane,303,449,518,708,146,190
944,2560,2560,JPEG,RGB,False,1,7ab2461e-fad4-4d90-a260-8317bbc4e958.jpg,Airplane,878,988,698,786,110,88
945,2560,2560,JPEG,RGB,False,1,7ab2461e-fad4-4d90-a260-8317bbc4e958.jpg,Airplane,928,1073,545,670,145,125
946,2560,2560,JPEG,RGB,False,1,7ab2461e-fad4-4d90-a260-8317bbc4e958.jpg,Airplane,995,1104,411,500,109,89
947,2560,2560,JPEG,RGB,False,1,7ab2461e-fad4-4d90-a260-8317bbc4e958.jpg,Airplane,1075,1193,283,382,118,99
948,2560,2560,JPEG,RGB,False,1,7ab2461e-fad4-4d90-a260-8317bbc4e958.jpg,Airplane,1215,1341,198,298,126,100
949,2560,2560,JPEG,RGB,False,1,7ab2461e-fad4-4d90-a260-8317bbc4e958.jpg,Airplane,1372,1467,300,393,95,93
950,2560,2560,JPEG,RGB,False,1,7ab2461e-fad4-4d90-a260-8317bbc4e958.jpg,Airplane,1424,1522,504,588,98,84
951,2560,2560,JPEG,RGB,False,1,7ab2461e-fad4-4d90-a260-8317bbc4e958.jpg,Airplane,961,1105,912,1072,144,160
952,2560,2560,JPEG,RGB,False,1,7ab2461e-fad4-4d90-a260-8317bbc4e958.jpg,Airplane,1131,1311,1143,1293,180,150
953,2560,2560,JPEG,RGB,False,1,7ab2461e-fad4-4d90-a260-8317bbc4e958.jpg,Airplane,1187,1291,981,1068,104,87
954,2560,2560,JPEG,RGB,False,1,7ab2461e-fad4-4d90-a260-8317bbc4e958.jpg,Airplane,1538,1721,980,1149,183,169
955,2560,2560,JPEG,RGB,False,1,7ab2461e-fad4-4d90-a260-8317bbc4e958.jpg,Airplane,1900,2049,669,823,149,154
956,2560,2560,JPEG,RGB,False,1,7ab2461e-fad4-4d90-a260-8317bbc4e958.jpg,Airplane,2084,2194,755,897,110,142
957,2560,2560,JPEG,RGB,False,1,7ab2461e-fad4-4d90-a260-8317bbc4e958.jpg,Airplane,2248,2328,807,909,80,102
958,2560,2560,JPEG,RGB,False,1,7ab2461e-fad4-4d90-a260-8317bbc4e958.jpg,Airplane,2237,2360,441,576,123,135
959,2560,2560,JPEG,RGB,False,1,7ab2461e-fad4-4d90-a260-8317bbc4e958.jpg,Airplane,1933,2007,294,383,74,89
960,2560,2560,JPEG,RGB,False,1,7ab2461e-fad4-4d90-a260-8317bbc4e958.jpg,Airplane,521,628,877,959,107,82
961,2560,2560,JPEG,RGB,False,1,7ab2461e-fad4-4d90-a260-8317bbc4e958.jpg,Airplane,450,557,1024,1111,107,87
962,2560,2560,JPEG,RGB,False,1,7ab2461e-fad4-4d90-a260-8317bbc4e958.jpg,Airplane,332,488,1149,1297,156,148
963,2560,2560,JPEG,RGB,False,1,7ab2461e-fad4-4d90-a260-8317bbc4e958.jpg,Airplane,299,407,1327,1418,108,91
964,2560,2560,JPEG,RGB,False,1,7ab2461e-fad4-4d90-a260-8317bbc4e958.jpg,Airplane,125,215,1492,1599,90,107
965,2560,2560,JPEG,RGB,False,1,7ab2461e-fad4-4d90-a260-8317bbc4e958.jpg,Airplane,24,97,1545,1646,73,101
966,2560,2560,JPEG,RGB,False,1,7ab2461e-fad4-4d90-a260-8317bbc4e958.jpg,Airplane,664,756,601,677,92,76
967,2560,2560,JPEG,RGB,False,1,7ab2461e-fad4-4d90-a260-8317bbc4e958.jpg,Airplane,1244,1358,847,929,114,82
968,2560,2560,JPEG,RGB,False,1,7ab2461e-fad4-4d90-a260-8317bbc4e958.jpg,Airplane,662,834,1114,1261,172,147
969,2560,2560,JPEG,RGB,False,1,54b4e42b-3667-4564-b8fa-c23122ca54d5.jpg,Truncated_airplane,2485,2557,2399,2481,72,82
970,2560,2560,JPEG,RGB,False,1,54b4e42b-3667-4564-b8fa-c23122ca54d5.jpg,Airplane,2279,2363,2427,2502,84,75
971,2560,2560,JPEG,RGB,False,1,54b4e42b-3667-4564-b8fa-c23122ca54d5.jpg,Airplane,2318,2418,2349,2418,100,69
972,2560,2560,JPEG,RGB,False,1,54b4e42b-3667-4564-b8fa-c23122ca54d5.jpg,Airplane,2225,2320,2231,2296,95,65
973,2560,2560,JPEG,RGB,False,1,54b4e42b-3667-4564-b8fa-c23122ca54d5.jpg,Airplane,2277,2376,2117,2195,99,78
974,2560,2560,JPEG,RGB,False,1,54b4e42b-3667-4564-b8fa-c23122ca54d5.jpg,Airplane,2125,2190,2120,2192,65,72
975,2560,2560,JPEG,RGB,False,1,54b4e42b-3667-4564-b8fa-c23122ca54d5.jpg,Airplane,2115,2186,1934,2027,71,93
976,2560,2560,JPEG,RGB,False,1,54b4e42b-3667-4564-b8fa-c23122ca54d5.jpg,Airplane,1920,1994,1982,2072,74,90
977,2560,2560,JPEG,RGB,False,1,54b4e42b-3667-4564-b8fa-c23122ca54d5.jpg,Airplane,1838,1909,1959,2050,71,91
978,2560,2560,JPEG,RGB,False,1,54b4e42b-3667-4564-b8fa-c23122ca54d5.jpg,Airplane,2054,2164,1634,1759,110,125
979,2560,2560,JPEG,RGB,False,1,54b4e42b-3667-4564-b8fa-c23122ca54d5.jpg,Airplane,2152,2228,1588,1667,76,79
980,2560,2560,JPEG,RGB,False,1,54b4e42b-3667-4564-b8fa-c23122ca54d5.jpg,Airplane,2195,2267,1511,1587,72,76
981,2560,2560,JPEG,RGB,False,1,54b4e42b-3667-4564-b8fa-c23122ca54d5.jpg,Airplane,1975,2040,1692,1772,65,80
982,2560,2560,JPEG,RGB,False,1,54b4e42b-3667-4564-b8fa-c23122ca54d5.jpg,Airplane,1885,1957,1690,1777,72,87
983,2560,2560,JPEG,RGB,False,1,54b4e42b-3667-4564-b8fa-c23122ca54d5.jpg,Airplane,1798,1867,1694,1774,69,80
984,2560,2560,JPEG,RGB,False,1,54b4e42b-3667-4564-b8fa-c23122ca54d5.jpg,Airplane,1711,1791,1717,1803,80,86
985,2560,2560,JPEG,RGB,False,1,54b4e42b-3667-4564-b8fa-c23122ca54d5.jpg,Airplane,1631,1705,1943,2029,74,86
986,2560,2560,JPEG,RGB,False,1,54b4e42b-3667-4564-b8fa-c23122ca54d5.jpg,Airplane,2268,2338,1348,1416,70,68
987,2560,2560,JPEG,RGB,False,1,54b4e42b-3667-4564-b8fa-c23122ca54d5.jpg,Airplane,2349,2442,1145,1221,93,76
988,2560,2560,JPEG,RGB,False,1,54b4e42b-3667-4564-b8fa-c23122ca54d5.jpg,Airplane,2327,2415,863,936,88,73
989,2560,2560,JPEG,RGB,False,1,54b4e42b-3667-4564-b8fa-c23122ca54d5.jpg,Airplane,2305,2377,789,862,72,73
990,2560,2560,JPEG,RGB,False,1,54b4e42b-3667-4564-b8fa-c23122ca54d5.jpg,Airplane,2279,2363,704,777,84,73
991,2560,2560,JPEG,RGB,False,1,54b4e42b-3667-4564-b8fa-c23122ca54d5.jpg,Airplane,2249,2318,636,709,69,73
992,2560,2560,JPEG,RGB,False,1,54b4e42b-3667-4564-b8fa-c23122ca54d5.jpg,Airplane,2182,2253,571,649,71,78
993,2560,2560,JPEG,RGB,False,1,54b4e42b-3667-4564-b8fa-c23122ca54d5.jpg,Airplane,2362,2443,377,452,81,75
994,2560,2560,JPEG,RGB,False,1,54b4e42b-3667-4564-b8fa-c23122ca54d5.jpg,Airplane,2054,2121,452,527,67,75
995,2560,2560,JPEG,RGB,False,1,54b4e42b-3667-4564-b8fa-c23122ca54d5.jpg,Airplane,1966,2028,423,502,62,79
996,2560,2560,JPEG,RGB,False,1,54b4e42b-3667-4564-b8fa-c23122ca54d5.jpg,Airplane,1865,1938,414,491,73,77
997,2560,2560,JPEG,RGB,False,1,54b4e42b-3667-4564-b8fa-c23122ca54d5.jpg,Airplane,1780,1855,416,487,75,71
998,2560,2560,JPEG,RGB,False,1,54b4e42b-3667-4564-b8fa-c23122ca54d5.jpg,Airplane,1705,1773,398,481,68,83
999,2560,2560,JPEG,RGB,False,1,54b4e42b-3667-4564-b8fa-c23122ca54d5.jpg,Airplane,1624,1699,341,420,75,79
1000,2560,2560,JPEG,RGB,False,1,54b4e42b-3667-4564-b8fa-c23122ca54d5.jpg,Airplane,997,1037,366,423,40,57
1001,2560,2560,JPEG,RGB,False,1,54b4e42b-3667-4564-b8fa-c23122ca54d5.jpg,Airplane,928,972,361,426,44,65
1002,2560,2560,JPEG,RGB,False,1,54b4e42b-3667-4564-b8fa-c23122ca54d5.jpg,Airplane,861,909,371,440,48,69
1003,2560,2560,JPEG,RGB,False,1,54b4e42b-3667-4564-b8fa-c23122ca54d5.jpg,Airplane,784,839,395,455,55,60
1004,2560,2560,JPEG,RGB,False,1,54b4e42b-3667-4564-b8fa-c23122ca54d5.jpg,Airplane,501,549,411,474,48,63
1005,2560,2560,JPEG,RGB,False,1,54b4e42b-3667-4564-b8fa-c23122ca54d5.jpg,Airplane,449,490,416,476,41,60
1006,2560,2560,JPEG,RGB,False,1,54b4e42b-3667-4564-b8fa-c23122ca54d5.jpg,Airplane,345,393,401,461,48,60
1007,2560,2560,JPEG,RGB,False,1,54b4e42b-3667-4564-b8fa-c23122ca54d5.jpg,Airplane,282,330,414,473,48,59
1008,2560,2560,JPEG,RGB,False,1,54b4e42b-3667-4564-b8fa-c23122ca54d5.jpg,Airplane,159,214,412,453,55,41
1009,2560,2560,JPEG,RGB,False,1,54b4e42b-3667-4564-b8fa-c23122ca54d5.jpg,Airplane,136,188,548,590,52,42
1010,2560,2560,JPEG,RGB,False,1,54b4e42b-3667-4564-b8fa-c23122ca54d5.jpg,Airplane,279,331,562,602,52,40
1011,2560,2560,JPEG,RGB,False,1,54b4e42b-3667-4564-b8fa-c23122ca54d5.jpg,Airplane,364,417,579,621,53,42
1012,2560,2560,JPEG,RGB,False,1,54b4e42b-3667-4564-b8fa-c23122ca54d5.jpg,Airplane,472,556,77,124,84,47
1013,2560,2560,JPEG,RGB,False,1,54b4e42b-3667-4564-b8fa-c23122ca54d5.jpg,Airplane,418,473,711,773,55,62
1014,2560,2560,JPEG,RGB,False,1,54b4e42b-3667-4564-b8fa-c23122ca54d5.jpg,Airplane,370,432,820,871,62,51
1015,2560,2560,JPEG,RGB,False,1,54b4e42b-3667-4564-b8fa-c23122ca54d5.jpg,Airplane,352,421,878,927,69,49
1016,2560,2560,JPEG,RGB,False,1,54b4e42b-3667-4564-b8fa-c23122ca54d5.jpg,Airplane,308,378,928,985,70,57
1017,2560,2560,JPEG,RGB,False,1,54b4e42b-3667-4564-b8fa-c23122ca54d5.jpg,Airplane,326,395,1003,1054,69,51
1018,2560,2560,JPEG,RGB,False,1,54b4e42b-3667-4564-b8fa-c23122ca54d5.jpg,Airplane,313,389,1139,1188,76,49
1019,2560,2560,JPEG,RGB,False,1,54b4e42b-3667-4564-b8fa-c23122ca54d5.jpg,Airplane,150,208,1197,1242,58,45
1020,2560,2560,JPEG,RGB,False,1,54b4e42b-3667-4564-b8fa-c23122ca54d5.jpg,Airplane,372,442,1322,1372,70,50
1021,2560,2560,JPEG,RGB,False,1,54b4e42b-3667-4564-b8fa-c23122ca54d5.jpg,Airplane,230,282,1292,1336,52,44
1022,2560,2560,JPEG,RGB,False,1,54b4e42b-3667-4564-b8fa-c23122ca54d5.jpg,Airplane,162,234,1471,1516,72,45
1023,2560,2560,JPEG,RGB,False,1,54b4e42b-3667-4564-b8fa-c23122ca54d5.jpg,Airplane,196,259,1538,1582,63,44
1024,2560,2560,JPEG,RGB,False,1,54b4e42b-3667-4564-b8fa-c23122ca54d5.jpg,Airplane,245,301,1595,1640,56,45
1025,2560,2560,JPEG,RGB,False,1,54b4e42b-3667-4564-b8fa-c23122ca54d5.jpg,Airplane,292,351,1646,1699,59,53
1026,2560,2560,JPEG,RGB,False,1,54b4e42b-3667-4564-b8fa-c23122ca54d5.jpg,Airplane,430,494,1430,1484,64,54
1027,2560,2560,JPEG,RGB,False,1,54b4e42b-3667-4564-b8fa-c23122ca54d5.jpg,Airplane,471,533,1488,1547,62,59
1028,2560,2560,JPEG,RGB,False,1,54b4e42b-3667-4564-b8fa-c23122ca54d5.jpg,Airplane,566,624,1580,1641,58,61
1029,2560,2560,JPEG,RGB,False,1,54b4e42b-3667-4564-b8fa-c23122ca54d5.jpg,Airplane,811,866,1656,1727,55,71
1030,2560,2560,JPEG,RGB,False,1,54b4e42b-3667-4564-b8fa-c23122ca54d5.jpg,Airplane,880,942,1671,1740,62,69
1031,2560,2560,JPEG,RGB,False,1,54b4e42b-3667-4564-b8fa-c23122ca54d5.jpg,Airplane,947,1006,1852,1902,59,50
1032,2560,2560,JPEG,RGB,False,1,54b4e42b-3667-4564-b8fa-c23122ca54d5.jpg,Airplane,946,1020,1905,1960,74,55
1033,2560,2560,JPEG,RGB,False,1,54b4e42b-3667-4564-b8fa-c23122ca54d5.jpg,Airplane,987,1061,2068,2149,74,81
1034,2560,2560,JPEG,RGB,False,1,54b4e42b-3667-4564-b8fa-c23122ca54d5.jpg,Airplane,726,803,2054,2132,77,78
1035,2560,2560,JPEG,RGB,False,1,54b4e42b-3667-4564-b8fa-c23122ca54d5.jpg,Airplane,284,420,2431,2556,136,125
1036,2560,2560,JPEG,RGB,False,1,576827bc-a94a-4611-8820-f3d56e969151.jpg,Truncated_airplane,245,412,358,532,167,174
1037,2560,2560,JPEG,RGB,False,1,576827bc-a94a-4611-8820-f3d56e969151.jpg,Truncated_airplane,9,196,367,534,187,167
1038,2560,2560,JPEG,RGB,False,1,576827bc-a94a-4611-8820-f3d56e969151.jpg,Airplane,1625,1825,309,465,200,156
1039,2560,2560,JPEG,RGB,False,1,576827bc-a94a-4611-8820-f3d56e969151.jpg,Airplane,1037,1224,333,489,187,156
1040,2560,2560,JPEG,RGB,False,1,576827bc-a94a-4611-8820-f3d56e969151.jpg,Airplane,279,489,555,738,210,183
1041,2560,2560,JPEG,RGB,False,1,576827bc-a94a-4611-8820-f3d56e969151.jpg,Airplane,242,453,773,965,211,192
1042,2560,2560,JPEG,RGB,False,1,576827bc-a94a-4611-8820-f3d56e969151.jpg,Airplane,912,1092,500,666,180,166
1043,2560,2560,JPEG,RGB,False,1,576827bc-a94a-4611-8820-f3d56e969151.jpg,Airplane,803,971,674,823,168,149
1044,2560,2560,JPEG,RGB,False,1,576827bc-a94a-4611-8820-f3d56e969151.jpg,Airplane,719,891,849,1010,172,161
1045,2560,2560,JPEG,RGB,False,1,576827bc-a94a-4611-8820-f3d56e969151.jpg,Airplane,644,821,1036,1197,177,161
1046,2560,2560,JPEG,RGB,False,1,576827bc-a94a-4611-8820-f3d56e969151.jpg,Airplane,535,713,1185,1343,178,158
1047,2560,2560,JPEG,RGB,False,1,576827bc-a94a-4611-8820-f3d56e969151.jpg,Airplane,1511,1689,462,611,178,149
1048,2560,2560,JPEG,RGB,False,1,576827bc-a94a-4611-8820-f3d56e969151.jpg,Airplane,1402,1604,640,803,202,163
1049,2560,2560,JPEG,RGB,False,1,576827bc-a94a-4611-8820-f3d56e969151.jpg,Airplane,1861,2034,823,997,173,174
1050,2560,2560,JPEG,RGB,False,1,576827bc-a94a-4611-8820-f3d56e969151.jpg,Airplane,1164,1342,1026,1174,178,148
1051,2560,2560,JPEG,RGB,False,1,576827bc-a94a-4611-8820-f3d56e969151.jpg,Airplane,1049,1215,1183,1320,166,137
1052,2560,2560,JPEG,RGB,False,1,576827bc-a94a-4611-8820-f3d56e969151.jpg,Airplane,831,998,1427,1570,167,143
1053,2560,2560,JPEG,RGB,False,1,576827bc-a94a-4611-8820-f3d56e969151.jpg,Airplane,1245,1344,1411,1521,99,110
1054,2560,2560,JPEG,RGB,False,1,576827bc-a94a-4611-8820-f3d56e969151.jpg,Airplane,2224,2403,1463,1652,179,189
1055,2560,2560,JPEG,RGB,False,1,576827bc-a94a-4611-8820-f3d56e969151.jpg,Airplane,1779,1950,1440,1621,171,181
1056,2560,2560,JPEG,RGB,False,1,576827bc-a94a-4611-8820-f3d56e969151.jpg,Airplane,1588,1767,1435,1614,179,179
1057,2560,2560,JPEG,RGB,False,1,576827bc-a94a-4611-8820-f3d56e969151.jpg,Airplane,1406,1578,1536,1729,172,193
1058,2560,2560,JPEG,RGB,False,1,576827bc-a94a-4611-8820-f3d56e969151.jpg,Airplane,861,1034,1706,1888,173,182
1059,2560,2560,JPEG,RGB,False,1,576827bc-a94a-4611-8820-f3d56e969151.jpg,Airplane,2268,2372,1872,1978,104,106
1060,2560,2560,JPEG,RGB,False,1,576827bc-a94a-4611-8820-f3d56e969151.jpg,Airplane,2153,2246,1866,1983,93,117
1061,2560,2560,JPEG,RGB,False,1,576827bc-a94a-4611-8820-f3d56e969151.jpg,Airplane,2033,2129,1857,1948,96,91
1062,2560,2560,JPEG,RGB,False,1,576827bc-a94a-4611-8820-f3d56e969151.jpg,Airplane,1912,2012,1853,1944,100,91
1063,2560,2560,JPEG,RGB,False,1,576827bc-a94a-4611-8820-f3d56e969151.jpg,Airplane,1793,1890,1838,1942,97,104
1064,2560,2560,JPEG,RGB,False,1,576827bc-a94a-4611-8820-f3d56e969151.jpg,Airplane,2012,2121,2140,2275,109,135
1065,2560,2560,JPEG,RGB,False,1,576827bc-a94a-4611-8820-f3d56e969151.jpg,Airplane,1772,1882,2141,2267,110,126
1066,2560,2560,JPEG,RGB,False,1,576827bc-a94a-4611-8820-f3d56e969151.jpg,Airplane,2108,2208,2429,2532,100,103
1067,2560,2560,JPEG,RGB,False,1,576827bc-a94a-4611-8820-f3d56e969151.jpg,Airplane,1986,2084,2430,2540,98,110
1068,2560,2560,JPEG,RGB,False,1,576827bc-a94a-4611-8820-f3d56e969151.jpg,Airplane,1636,1740,2417,2523,104,106
1069,2560,2560,JPEG,RGB,False,1,576827bc-a94a-4611-8820-f3d56e969151.jpg,Airplane,1493,1591,2417,2514,98,97
1070,2560,2560,JPEG,RGB,False,1,576827bc-a94a-4611-8820-f3d56e969151.jpg,Airplane,1165,1297,2116,2268,132,152
1071,2560,2560,JPEG,RGB,False,1,576827bc-a94a-4611-8820-f3d56e969151.jpg,Airplane,1024,1127,2140,2257,103,117
1072,2560,2560,JPEG,RGB,False,1,576827bc-a94a-4611-8820-f3d56e969151.jpg,Airplane,860,993,2117,2279,133,162
1073,2560,2560,JPEG,RGB,False,1,58956bcc-11fc-4357-8d75-32fee9feaf07.jpg,Airplane,2426,2509,30,124,83,94
1074,2560,2560,JPEG,RGB,False,1,58956bcc-11fc-4357-8d75-32fee9feaf07.jpg,Airplane,2317,2407,101,213,90,112
1075,2560,2560,JPEG,RGB,False,1,58956bcc-11fc-4357-8d75-32fee9feaf07.jpg,Airplane,2441,2493,381,450,52,69
1076,2560,2560,JPEG,RGB,False,1,58956bcc-11fc-4357-8d75-32fee9feaf07.jpg,Airplane,967,1056,72,170,89,98
1077,2560,2560,JPEG,RGB,False,1,58956bcc-11fc-4357-8d75-32fee9feaf07.jpg,Airplane,683,779,418,511,96,93
1078,2560,2560,JPEG,RGB,False,1,58956bcc-11fc-4357-8d75-32fee9feaf07.jpg,Airplane,1894,1944,438,504,50,66
1079,2560,2560,JPEG,RGB,False,1,58956bcc-11fc-4357-8d75-32fee9feaf07.jpg,Airplane,642,769,531,638,127,107
1080,2560,2560,JPEG,RGB,False,1,58956bcc-11fc-4357-8d75-32fee9feaf07.jpg,Airplane,710,845,648,771,135,123
1081,2560,2560,JPEG,RGB,False,1,58956bcc-11fc-4357-8d75-32fee9feaf07.jpg,Airplane,739,812,814,874,73,60
1082,2560,2560,JPEG,RGB,False,1,58956bcc-11fc-4357-8d75-32fee9feaf07.jpg,Airplane,653,770,893,1017,117,124
1083,2560,2560,JPEG,RGB,False,1,58956bcc-11fc-4357-8d75-32fee9feaf07.jpg,Airplane,479,536,998,1067,57,69
1084,2560,2560,JPEG,RGB,False,1,58956bcc-11fc-4357-8d75-32fee9feaf07.jpg,Airplane,2065,2169,975,1065,104,90
1085,2560,2560,JPEG,RGB,False,1,58956bcc-11fc-4357-8d75-32fee9feaf07.jpg,Airplane,1632,1690,1003,1059,58,56
1086,2560,2560,JPEG,RGB,False,1,58956bcc-11fc-4357-8d75-32fee9feaf07.jpg,Airplane,1565,1676,1149,1242,111,93
1087,2560,2560,JPEG,RGB,False,1,58956bcc-11fc-4357-8d75-32fee9feaf07.jpg,Airplane,496,619,1257,1351,123,94
1088,2560,2560,JPEG,RGB,False,1,58956bcc-11fc-4357-8d75-32fee9feaf07.jpg,Airplane,442,496,1378,1446,54,68
1089,2560,2560,JPEG,RGB,False,1,58956bcc-11fc-4357-8d75-32fee9feaf07.jpg,Airplane,246,319,1505,1563,73,58
1090,2560,2560,JPEG,RGB,False,1,58956bcc-11fc-4357-8d75-32fee9feaf07.jpg,Airplane,2005,2062,1491,1552,57,61
1091,2560,2560,JPEG,RGB,False,1,58956bcc-11fc-4357-8d75-32fee9feaf07.jpg,Airplane,1333,1387,1772,1817,54,45
1092,2560,2560,JPEG,RGB,False,1,58956bcc-11fc-4357-8d75-32fee9feaf07.jpg,Airplane,1209,1311,1978,2077,102,99
1093,2560,2560,JPEG,RGB,False,1,58956bcc-11fc-4357-8d75-32fee9feaf07.jpg,Airplane,1627,1671,1943,1986,44,43
1094,2560,2560,JPEG,RGB,False,1,58956bcc-11fc-4357-8d75-32fee9feaf07.jpg,Airplane,1580,1645,2022,2076,65,54
1095,2560,2560,JPEG,RGB,False,1,58956bcc-11fc-4357-8d75-32fee9feaf07.jpg,Airplane,1773,1872,2357,2471,99,114
1096,2560,2560,JPEG,RGB,False,1,58956bcc-11fc-4357-8d75-32fee9feaf07.jpg,Airplane,1440,1546,2296,2394,106,98
1097,2560,2560,JPEG,RGB,False,1,58956bcc-11fc-4357-8d75-32fee9feaf07.jpg,Airplane,797,912,2396,2488,115,92
1098,2560,2560,JPEG,RGB,False,1,58956bcc-11fc-4357-8d75-32fee9feaf07.jpg,Airplane,38,165,2444,2560,127,116
1099,2560,2560,JPEG,RGB,False,1,58956bcc-11fc-4357-8d75-32fee9feaf07.jpg,Truncated_airplane,178,258,2498,2559,80,61
1100,2560,2560,JPEG,RGB,False,1,58956bcc-11fc-4357-8d75-32fee9feaf07.jpg,Airplane,1432,1492,1479,1530,60,51
1101,2560,2560,JPEG,RGB,False,1,58956bcc-11fc-4357-8d75-32fee9feaf07.jpg,Airplane,2520,2562,315,378,42,63
1102,2560,2560,JPEG,RGB,False,1,65e32857-71dc-406b-8583-1ea6467a330f.jpg,Airplane,1928,2001,2171,2251,73,80
1103,2560,2560,JPEG,RGB,False,1,65e32857-71dc-406b-8583-1ea6467a330f.jpg,Airplane,2033,2108,2137,2205,75,68
1104,2560,2560,JPEG,RGB,False,1,65e32857-71dc-406b-8583-1ea6467a330f.jpg,Airplane,2142,2220,1940,2015,78,75
1105,2560,2560,JPEG,RGB,False,1,65e32857-71dc-406b-8583-1ea6467a330f.jpg,Airplane,1829,1897,2007,2077,68,70
1106,2560,2560,JPEG,RGB,False,1,65e32857-71dc-406b-8583-1ea6467a330f.jpg,Airplane,1701,1778,1752,1827,77,75
1107,2560,2560,JPEG,RGB,False,1,65e32857-71dc-406b-8583-1ea6467a330f.jpg,Airplane,1981,2051,1619,1688,70,69
1108,2560,2560,JPEG,RGB,False,1,65e32857-71dc-406b-8583-1ea6467a330f.jpg,Airplane,2063,2144,1764,1840,81,76
1109,2560,2560,JPEG,RGB,False,1,65e32857-71dc-406b-8583-1ea6467a330f.jpg,Airplane,1547,1612,1437,1505,65,68
1110,2560,2560,JPEG,RGB,False,1,65e32857-71dc-406b-8583-1ea6467a330f.jpg,Airplane,1277,1347,1476,1545,70,69
1111,2560,2560,JPEG,RGB,False,1,65e32857-71dc-406b-8583-1ea6467a330f.jpg,Airplane,655,748,1474,1543,93,69
1112,2560,2560,JPEG,RGB,False,1,65e32857-71dc-406b-8583-1ea6467a330f.jpg,Airplane,647,730,1392,1463,83,71
1113,2560,2560,JPEG,RGB,False,1,65e32857-71dc-406b-8583-1ea6467a330f.jpg,Airplane,653,722,1300,1378,69,78
1114,2560,2560,JPEG,RGB,False,1,65e32857-71dc-406b-8583-1ea6467a330f.jpg,Airplane,715,783,1217,1313,68,96
1115,2560,2560,JPEG,RGB,False,1,65e32857-71dc-406b-8583-1ea6467a330f.jpg,Airplane,907,1001,1214,1283,94,69
1116,2560,2560,JPEG,RGB,False,1,65e32857-71dc-406b-8583-1ea6467a330f.jpg,Airplane,881,984,1121,1186,103,65
1117,2560,2560,JPEG,RGB,False,1,65e32857-71dc-406b-8583-1ea6467a330f.jpg,Airplane,897,966,942,1012,69,70
1118,2560,2560,JPEG,RGB,False,1,ef92f434-c41b-4423-9218-4514c49f00c6.jpg,Airplane,1950,2145,1375,1587,195,212
1119,2560,2560,JPEG,RGB,False,1,ef92f434-c41b-4423-9218-4514c49f00c6.jpg,Airplane,1738,1857,1202,1346,119,144
1120,2560,2560,JPEG,RGB,False,1,ef92f434-c41b-4423-9218-4514c49f00c6.jpg,Airplane,2401,2492,1055,1178,91,123
1121,2560,2560,JPEG,RGB,False,1,ef92f434-c41b-4423-9218-4514c49f00c6.jpg,Airplane,2191,2314,967,1113,123,146
1122,2560,2560,JPEG,RGB,False,1,ef92f434-c41b-4423-9218-4514c49f00c6.jpg,Airplane,1532,1652,690,838,120,148
1123,2560,2560,JPEG,RGB,False,1,ef92f434-c41b-4423-9218-4514c49f00c6.jpg,Airplane,1667,1754,980,1066,87,86
1124,2560,2560,JPEG,RGB,False,1,ef92f434-c41b-4423-9218-4514c49f00c6.jpg,Airplane,1542,1690,1111,1273,148,162
1125,2560,2560,JPEG,RGB,False,1,ef92f434-c41b-4423-9218-4514c49f00c6.jpg,Airplane,1546,1697,1517,1703,151,186
1126,2560,2560,JPEG,RGB,False,1,ef92f434-c41b-4423-9218-4514c49f00c6.jpg,Airplane,1381,1543,1429,1606,162,177
1127,2560,2560,JPEG,RGB,False,1,ef92f434-c41b-4423-9218-4514c49f00c6.jpg,Airplane,1093,1263,1552,1713,170,161
1128,2560,2560,JPEG,RGB,False,1,ef92f434-c41b-4423-9218-4514c49f00c6.jpg,Airplane,1032,1216,1753,1921,184,168
1129,2560,2560,JPEG,RGB,False,1,ef92f434-c41b-4423-9218-4514c49f00c6.jpg,Airplane,1551,1746,2360,2519,195,159
1130,2560,2560,JPEG,RGB,False,1,ef92f434-c41b-4423-9218-4514c49f00c6.jpg,Airplane,82,256,2049,2214,174,165
1131,2560,2560,JPEG,RGB,False,1,ef92f434-c41b-4423-9218-4514c49f00c6.jpg,Airplane,150,338,1878,2047,188,169
1132,2560,2560,JPEG,RGB,False,1,ef92f434-c41b-4423-9218-4514c49f00c6.jpg,Airplane,467,554,1745,1847,87,102
1133,2560,2560,JPEG,RGB,False,1,ef92f434-c41b-4423-9218-4514c49f00c6.jpg,Airplane,285,443,1593,1742,158,149
1134,2560,2560,JPEG,RGB,False,1,ef92f434-c41b-4423-9218-4514c49f00c6.jpg,Airplane,77,190,1507,1590,113,83
1135,2560,2560,JPEG,RGB,False,1,ef92f434-c41b-4423-9218-4514c49f00c6.jpg,Airplane,138,246,1363,1452,108,89
1136,2560,2560,JPEG,RGB,False,1,ef92f434-c41b-4423-9218-4514c49f00c6.jpg,Airplane,381,476,1473,1564,95,91
1137,2560,2560,JPEG,RGB,False,1,ef92f434-c41b-4423-9218-4514c49f00c6.jpg,Airplane,763,942,1412,1571,179,159
1138,2560,2560,JPEG,RGB,False,1,ef92f434-c41b-4423-9218-4514c49f00c6.jpg,Airplane,910,1012,1276,1367,102,91
1139,2560,2560,JPEG,RGB,False,1,ef92f434-c41b-4423-9218-4514c49f00c6.jpg,Airplane,416,575,1303,1455,159,152
1140,2560,2560,JPEG,RGB,False,1,ef92f434-c41b-4423-9218-4514c49f00c6.jpg,Airplane,488,601,1186,1273,113,87
1141,2560,2560,JPEG,RGB,False,1,ef92f434-c41b-4423-9218-4514c49f00c6.jpg,Airplane,589,672,1054,1140,83,86
1142,2560,2560,JPEG,RGB,False,1,ef92f434-c41b-4423-9218-4514c49f00c6.jpg,Airplane,717,833,976,1071,116,95
1143,2560,2560,JPEG,RGB,False,1,ef92f434-c41b-4423-9218-4514c49f00c6.jpg,Airplane,867,952,1057,1178,85,121
1144,2560,2560,JPEG,RGB,False,1,ef92f434-c41b-4423-9218-4514c49f00c6.jpg,Truncated_airplane,638,727,2490,2560,89,70
1145,2560,2560,JPEG,RGB,False,1,ef92f434-c41b-4423-9218-4514c49f00c6.jpg,Truncated_airplane,537,597,2522,2559,60,37
1146,2560,2560,JPEG,RGB,False,1,ef92f434-c41b-4423-9218-4514c49f00c6.jpg,Airplane,624,805,1909,2064,181,155
1147,2560,2560,JPEG,RGB,False,1,e18dde99-6efd-4c6a-8fd3-343e8a393cd8.jpg,Airplane,784,892,280,413,108,133
1148,2560,2560,JPEG,RGB,False,1,e18dde99-6efd-4c6a-8fd3-343e8a393cd8.jpg,Airplane,1297,1433,356,501,136,145
1149,2560,2560,JPEG,RGB,False,1,e18dde99-6efd-4c6a-8fd3-343e8a393cd8.jpg,Airplane,901,1028,748,864,127,116
1150,2560,2560,JPEG,RGB,False,1,e18dde99-6efd-4c6a-8fd3-343e8a393cd8.jpg,Airplane,762,896,985,1092,134,107
1151,2560,2560,JPEG,RGB,False,1,e18dde99-6efd-4c6a-8fd3-343e8a393cd8.jpg,Airplane,693,821,1094,1200,128,106
1152,2560,2560,JPEG,RGB,False,1,e18dde99-6efd-4c6a-8fd3-343e8a393cd8.jpg,Airplane,1023,1085,1258,1329,62,71
1153,2560,2560,JPEG,RGB,False,1,e18dde99-6efd-4c6a-8fd3-343e8a393cd8.jpg,Airplane,1194,1252,1338,1404,58,66
1154,2560,2560,JPEG,RGB,False,1,e18dde99-6efd-4c6a-8fd3-343e8a393cd8.jpg,Airplane,1277,1333,1428,1492,56,64
1155,2560,2560,JPEG,RGB,False,1,e18dde99-6efd-4c6a-8fd3-343e8a393cd8.jpg,Airplane,1377,1433,1408,1477,56,69
1156,2560,2560,JPEG,RGB,False,1,e18dde99-6efd-4c6a-8fd3-343e8a393cd8.jpg,Airplane,1422,1479,1516,1580,57,64
1157,2560,2560,JPEG,RGB,False,1,e18dde99-6efd-4c6a-8fd3-343e8a393cd8.jpg,Airplane,1658,1716,1451,1525,58,74
1158,2560,2560,JPEG,RGB,False,1,e18dde99-6efd-4c6a-8fd3-343e8a393cd8.jpg,Airplane,1666,1720,1593,1656,54,63
1159,2560,2560,JPEG,RGB,False,1,e18dde99-6efd-4c6a-8fd3-343e8a393cd8.jpg,Airplane,1874,1952,1727,1824,78,97
1160,2560,2560,JPEG,RGB,False,1,e18dde99-6efd-4c6a-8fd3-343e8a393cd8.jpg,Airplane,2109,2169,1885,1959,60,74
1161,2560,2560,JPEG,RGB,False,1,e18dde99-6efd-4c6a-8fd3-343e8a393cd8.jpg,Airplane,2229,2288,1947,2023,59,76
1162,2560,2560,JPEG,RGB,False,1,e18dde99-6efd-4c6a-8fd3-343e8a393cd8.jpg,Airplane,853,969,1443,1547,116,104
1163,2560,2560,JPEG,RGB,False,1,e18dde99-6efd-4c6a-8fd3-343e8a393cd8.jpg,Airplane,823,894,1564,1627,71,63
1164,2560,2560,JPEG,RGB,False,1,e18dde99-6efd-4c6a-8fd3-343e8a393cd8.jpg,Airplane,2328,2403,2149,2214,75,65
1165,2560,2560,JPEG,RGB,False,1,e18dde99-6efd-4c6a-8fd3-343e8a393cd8.jpg,Airplane,2256,2337,2264,2328,81,64
1166,2560,2560,JPEG,RGB,False,1,e18dde99-6efd-4c6a-8fd3-343e8a393cd8.jpg,Airplane,2165,2293,2365,2469,128,104
1167,2560,2560,JPEG,RGB,False,1,e18dde99-6efd-4c6a-8fd3-343e8a393cd8.jpg,Airplane,1393,1451,27,102,58,75
1168,2560,2560,JPEG,RGB,False,1,e18dde99-6efd-4c6a-8fd3-343e8a393cd8.jpg,Airplane,1465,1523,70,143,58,73
1169,2560,2560,JPEG,RGB,False,1,e18dde99-6efd-4c6a-8fd3-343e8a393cd8.jpg,Airplane,1596,1630,149,190,34,41
1170,2560,2560,JPEG,RGB,False,1,e18dde99-6efd-4c6a-8fd3-343e8a393cd8.jpg,Truncated_airplane,2516,2567,2170,2257,51,87
1171,2560,2560,JPEG,RGB,False,1,b3324b5e-cca9-42f7-9806-ab1f86eee050.jpg,Airplane,2392,2463,126,190,71,64
1172,2560,2560,JPEG,RGB,False,1,b3324b5e-cca9-42f7-9806-ab1f86eee050.jpg,Airplane,1801,1976,310,491,175,181
1173,2560,2560,JPEG,RGB,False,1,b3324b5e-cca9-42f7-9806-ab1f86eee050.jpg,Airplane,1531,1615,183,258,84,75
1174,2560,2560,JPEG,RGB,False,1,b3324b5e-cca9-42f7-9806-ab1f86eee050.jpg,Airplane,1714,1895,663,845,181,182
1175,2560,2560,JPEG,RGB,False,1,b3324b5e-cca9-42f7-9806-ab1f86eee050.jpg,Airplane,2234,2328,764,855,94,91
1176,2560,2560,JPEG,RGB,False,1,b3324b5e-cca9-42f7-9806-ab1f86eee050.jpg,Airplane,1495,1568,498,589,73,91
1177,2560,2560,JPEG,RGB,False,1,b3324b5e-cca9-42f7-9806-ab1f86eee050.jpg,Airplane,2280,2367,1336,1435,87,99
1178,2560,2560,JPEG,RGB,False,1,b3324b5e-cca9-42f7-9806-ab1f86eee050.jpg,Airplane,2173,2312,999,1153,139,154
1179,2560,2560,JPEG,RGB,False,1,b3324b5e-cca9-42f7-9806-ab1f86eee050.jpg,Airplane,2034,2175,1067,1230,141,163
1180,2560,2560,JPEG,RGB,False,1,b3324b5e-cca9-42f7-9806-ab1f86eee050.jpg,Airplane,1337,1498,1156,1301,161,145
1181,2560,2560,JPEG,RGB,False,1,b3324b5e-cca9-42f7-9806-ab1f86eee050.jpg,Airplane,781,899,863,952,118,89
1182,2560,2560,JPEG,RGB,False,1,b3324b5e-cca9-42f7-9806-ab1f86eee050.jpg,Airplane,850,989,994,1106,139,112
1183,2560,2560,JPEG,RGB,False,1,b3324b5e-cca9-42f7-9806-ab1f86eee050.jpg,Airplane,1011,1151,1256,1388,140,132
1184,2560,2560,JPEG,RGB,False,1,b3324b5e-cca9-42f7-9806-ab1f86eee050.jpg,Airplane,1433,1531,1615,1697,98,82
1185,2560,2560,JPEG,RGB,False,1,b3324b5e-cca9-42f7-9806-ab1f86eee050.jpg,Airplane,931,1039,1577,1675,108,98
1186,2560,2560,JPEG,RGB,False,1,b3324b5e-cca9-42f7-9806-ab1f86eee050.jpg,Airplane,1150,1248,1741,1825,98,84
1187,2560,2560,JPEG,RGB,False,1,b3324b5e-cca9-42f7-9806-ab1f86eee050.jpg,Airplane,1184,1298,2040,2131,114,91
1188,2560,2560,JPEG,RGB,False,1,b3324b5e-cca9-42f7-9806-ab1f86eee050.jpg,Airplane,247,375,1585,1700,128,115
1189,2560,2560,JPEG,RGB,False,1,b3324b5e-cca9-42f7-9806-ab1f86eee050.jpg,Airplane,603,742,1833,1951,139,118
1190,2560,2560,JPEG,RGB,False,1,b3324b5e-cca9-42f7-9806-ab1f86eee050.jpg,Airplane,645,756,1998,2092,111,94
1191,2560,2560,JPEG,RGB,False,1,b3324b5e-cca9-42f7-9806-ab1f86eee050.jpg,Airplane,1471,1551,2066,2120,80,54
1192,2560,2560,JPEG,RGB,False,1,b3324b5e-cca9-42f7-9806-ab1f86eee050.jpg,Airplane,1464,1540,2139,2192,76,53
1193,2560,2560,JPEG,RGB,False,1,b3324b5e-cca9-42f7-9806-ab1f86eee050.jpg,Airplane,1474,1550,2211,2253,76,42
1194,2560,2560,JPEG,RGB,False,1,b3324b5e-cca9-42f7-9806-ab1f86eee050.jpg,Airplane,1030,1104,2161,2232,74,71
1195,2560,2560,JPEG,RGB,False,1,dacabde6-c8a7-475b-ab26-81b4e4dd5977.jpg,Airplane,1,195,330,514,194,184
1196,2560,2560,JPEG,RGB,False,1,dacabde6-c8a7-475b-ab26-81b4e4dd5977.jpg,Airplane,1,180,600,774,179,174
1197,2560,2560,JPEG,RGB,False,1,dacabde6-c8a7-475b-ab26-81b4e4dd5977.jpg,Airplane,0,173,892,1058,173,166
1198,2560,2560,JPEG,RGB,False,1,dacabde6-c8a7-475b-ab26-81b4e4dd5977.jpg,Airplane,1,156,1131,1301,155,170
1199,2560,2560,JPEG,RGB,False,1,dacabde6-c8a7-475b-ab26-81b4e4dd5977.jpg,Airplane,1,204,1368,1545,203,177
1200,2560,2560,JPEG,RGB,False,1,dacabde6-c8a7-475b-ab26-81b4e4dd5977.jpg,Airplane,0,188,1580,1756,188,176
1201,2560,2560,JPEG,RGB,False,1,dacabde6-c8a7-475b-ab26-81b4e4dd5977.jpg,Airplane,0,172,1786,1958,172,172
1202,2560,2560,JPEG,RGB,False,1,dacabde6-c8a7-475b-ab26-81b4e4dd5977.jpg,Airplane,21,124,2021,2121,103,100
1203,2560,2560,JPEG,RGB,False,1,dacabde6-c8a7-475b-ab26-81b4e4dd5977.jpg,Airplane,955,1136,339,503,181,164
1204,2560,2560,JPEG,RGB,False,1,dacabde6-c8a7-475b-ab26-81b4e4dd5977.jpg,Airplane,954,1140,574,747,186,173
1205,2560,2560,JPEG,RGB,False,1,dacabde6-c8a7-475b-ab26-81b4e4dd5977.jpg,Airplane,505,714,576,752,209,176
1206,2560,2560,JPEG,RGB,False,1,dacabde6-c8a7-475b-ab26-81b4e4dd5977.jpg,Airplane,535,715,862,1034,180,172
1207,2560,2560,JPEG,RGB,False,1,dacabde6-c8a7-475b-ab26-81b4e4dd5977.jpg,Airplane,964,1168,845,1026,204,181
1208,2560,2560,JPEG,RGB,False,1,dacabde6-c8a7-475b-ab26-81b4e4dd5977.jpg,Airplane,953,1146,1087,1274,193,187
1209,2560,2560,JPEG,RGB,False,1,dacabde6-c8a7-475b-ab26-81b4e4dd5977.jpg,Airplane,532,714,1160,1324,182,164
1210,2560,2560,JPEG,RGB,False,1,dacabde6-c8a7-475b-ab26-81b4e4dd5977.jpg,Airplane,962,1147,1362,1533,185,171
1211,2560,2560,JPEG,RGB,False,1,dacabde6-c8a7-475b-ab26-81b4e4dd5977.jpg,Airplane,527,691,1380,1543,164,163
1212,2560,2560,JPEG,RGB,False,1,dacabde6-c8a7-475b-ab26-81b4e4dd5977.jpg,Airplane,529,706,1575,1745,177,170
1213,2560,2560,JPEG,RGB,False,1,dacabde6-c8a7-475b-ab26-81b4e4dd5977.jpg,Airplane,555,679,1814,1913,124,99
1214,2560,2560,JPEG,RGB,False,1,dacabde6-c8a7-475b-ab26-81b4e4dd5977.jpg,Airplane,973,1157,1578,1754,184,176
1215,2560,2560,JPEG,RGB,False,1,dacabde6-c8a7-475b-ab26-81b4e4dd5977.jpg,Airplane,983,1132,1990,2125,149,135
1216,2560,2560,JPEG,RGB,False,1,dacabde6-c8a7-475b-ab26-81b4e4dd5977.jpg,Airplane,1486,1664,902,1066,178,164
1217,2560,2560,JPEG,RGB,False,1,dacabde6-c8a7-475b-ab26-81b4e4dd5977.jpg,Airplane,1904,2077,1365,1525,173,160
1218,2560,2560,JPEG,RGB,False,1,dacabde6-c8a7-475b-ab26-81b4e4dd5977.jpg,Airplane,1493,1697,1680,1903,204,223
1219,2560,2560,JPEG,RGB,False,1,dacabde6-c8a7-475b-ab26-81b4e4dd5977.jpg,Airplane,1901,2100,1761,1944,199,183
1220,2560,2560,JPEG,RGB,False,1,dacabde6-c8a7-475b-ab26-81b4e4dd5977.jpg,Airplane,1912,2083,2015,2219,171,204
1221,2560,2560,JPEG,RGB,False,1,dacabde6-c8a7-475b-ab26-81b4e4dd5977.jpg,Airplane,1707,1883,2020,2200,176,180
1222,2560,2560,JPEG,RGB,False,1,dacabde6-c8a7-475b-ab26-81b4e4dd5977.jpg,Airplane,1,192,327,511,191,184
1223,2560,2560,JPEG,RGB,False,1,dacabde6-c8a7-475b-ab26-81b4e4dd5977.jpg,Truncated_airplane,0,171,597,776,171,179
1224,2560,2560,JPEG,RGB,False,1,dacabde6-c8a7-475b-ab26-81b4e4dd5977.jpg,Airplane,1,169,887,1058,168,171
1225,2560,2560,JPEG,RGB,False,1,dacabde6-c8a7-475b-ab26-81b4e4dd5977.jpg,Airplane,0,149,1127,1296,149,169
1226,2560,2560,JPEG,RGB,False,1,dacabde6-c8a7-475b-ab26-81b4e4dd5977.jpg,Airplane,1,192,1361,1542,191,181
1227,2560,2560,JPEG,RGB,False,1,dacabde6-c8a7-475b-ab26-81b4e4dd5977.jpg,Airplane,0,193,1579,1758,193,179
1228,2560,2560,JPEG,RGB,False,1,dacabde6-c8a7-475b-ab26-81b4e4dd5977.jpg,Airplane,0,171,1786,1953,171,167
1229,2560,2560,JPEG,RGB,False,1,dacabde6-c8a7-475b-ab26-81b4e4dd5977.jpg,Airplane,17,127,2019,2121,110,102
1230,2560,2560,JPEG,RGB,False,1,dacabde6-c8a7-475b-ab26-81b4e4dd5977.jpg,Airplane,552,680,1807,1908,128,101
1231,2560,2560,JPEG,RGB,False,1,dacabde6-c8a7-475b-ab26-81b4e4dd5977.jpg,Airplane,980,1133,1993,2130,153,137
1232,2560,2560,JPEG,RGB,False,1,dacabde6-c8a7-475b-ab26-81b4e4dd5977.jpg,Airplane,522,706,1576,1744,184,168
1233,2560,2560,JPEG,RGB,False,1,dacabde6-c8a7-475b-ab26-81b4e4dd5977.jpg,Airplane,973,1156,1582,1751,183,169
1234,2560,2560,JPEG,RGB,False,1,dacabde6-c8a7-475b-ab26-81b4e4dd5977.jpg,Airplane,529,696,1376,1541,167,165
1235,2560,2560,JPEG,RGB,False,1,dacabde6-c8a7-475b-ab26-81b4e4dd5977.jpg,Airplane,959,1144,1361,1532,185,171
1236,2560,2560,JPEG,RGB,False,1,dacabde6-c8a7-475b-ab26-81b4e4dd5977.jpg,Airplane,532,713,1154,1322,181,168
1237,2560,2560,JPEG,RGB,False,1,dacabde6-c8a7-475b-ab26-81b4e4dd5977.jpg,Airplane,952,1152,1090,1267,200,177
1238,2560,2560,JPEG,RGB,False,1,dacabde6-c8a7-475b-ab26-81b4e4dd5977.jpg,Airplane,533,714,868,1028,181,160
1239,2560,2560,JPEG,RGB,False,1,dacabde6-c8a7-475b-ab26-81b4e4dd5977.jpg,Airplane,963,1168,850,1028,205,178
1240,2560,2560,JPEG,RGB,False,1,dacabde6-c8a7-475b-ab26-81b4e4dd5977.jpg,Airplane,498,710,572,752,212,180
1241,2560,2560,JPEG,RGB,False,1,dacabde6-c8a7-475b-ab26-81b4e4dd5977.jpg,Airplane,957,1145,578,749,188,171
1242,2560,2560,JPEG,RGB,False,1,dacabde6-c8a7-475b-ab26-81b4e4dd5977.jpg,Airplane,958,1141,337,507,183,170
1243,2560,2560,JPEG,RGB,False,1,dacabde6-c8a7-475b-ab26-81b4e4dd5977.jpg,Airplane,1485,1663,898,1072,178,174
1244,2560,2560,JPEG,RGB,False,1,dacabde6-c8a7-475b-ab26-81b4e4dd5977.jpg,Airplane,1903,2081,1365,1527,178,162
1245,2560,2560,JPEG,RGB,False,1,dacabde6-c8a7-475b-ab26-81b4e4dd5977.jpg,Airplane,1490,1694,1683,1904,204,221
1246,2560,2560,JPEG,RGB,False,1,dacabde6-c8a7-475b-ab26-81b4e4dd5977.jpg,Airplane,1904,2100,1760,1941,196,181
1247,2560,2560,JPEG,RGB,False,1,dacabde6-c8a7-475b-ab26-81b4e4dd5977.jpg,Airplane,1702,1881,2016,2204,179,188
1248,2560,2560,JPEG,RGB,False,1,dacabde6-c8a7-475b-ab26-81b4e4dd5977.jpg,Airplane,1908,2084,2018,2219,176,201
1249,2560,2560,JPEG,RGB,False,1,4f833867-273e-4d73-8bc3-cb2d9ceb54ef.jpg,Airplane,135,245,522,600,110,78
1250,2560,2560,JPEG,RGB,False,1,4f833867-273e-4d73-8bc3-cb2d9ceb54ef.jpg,Airplane,1025,1125,284,384,100,100
1251,2560,2560,JPEG,RGB,False,1,4f833867-273e-4d73-8bc3-cb2d9ceb54ef.jpg,Airplane,1058,1130,1503,1568,72,65
1252,2560,2560,JPEG,RGB,False,1,4f833867-273e-4d73-8bc3-cb2d9ceb54ef.jpg,Airplane,813,885,1518,1604,72,86
1253,2560,2560,JPEG,RGB,False,1,4f833867-273e-4d73-8bc3-cb2d9ceb54ef.jpg,Airplane,594,657,938,1012,63,74
1254,2560,2560,JPEG,RGB,False,1,4f833867-273e-4d73-8bc3-cb2d9ceb54ef.jpg,Airplane,451,524,725,798,73,73
1255,2560,2560,JPEG,RGB,False,1,4f833867-273e-4d73-8bc3-cb2d9ceb54ef.jpg,Airplane,1543,1614,1437,1497,71,60
1256,2560,2560,JPEG,RGB,False,1,4f833867-273e-4d73-8bc3-cb2d9ceb54ef.jpg,Airplane,1485,1561,1370,1437,76,67
1257,2560,2560,JPEG,RGB,False,1,4f833867-273e-4d73-8bc3-cb2d9ceb54ef.jpg,Airplane,1968,2053,1624,1687,85,63
1258,2560,2560,JPEG,RGB,False,1,4f833867-273e-4d73-8bc3-cb2d9ceb54ef.jpg,Airplane,1659,1733,1674,1746,74,72
1259,2560,2560,JPEG,RGB,False,1,4f833867-273e-4d73-8bc3-cb2d9ceb54ef.jpg,Airplane,1865,1951,2091,2165,86,74
1260,2560,2560,JPEG,RGB,False,1,4f833867-273e-4d73-8bc3-cb2d9ceb54ef.jpg,Airplane,2052,2135,1772,1834,83,62
1261,2560,2560,JPEG,RGB,False,1,4f833867-273e-4d73-8bc3-cb2d9ceb54ef.jpg,Airplane,2146,2225,2031,2102,79,71
1262,2560,2560,JPEG,RGB,False,1,4f833867-273e-4d73-8bc3-cb2d9ceb54ef.jpg,Airplane,1006,1088,2345,2412,82,67
1263,2560,2560,JPEG,RGB,False,1,4f833867-273e-4d73-8bc3-cb2d9ceb54ef.jpg,Airplane,1931,2009,2163,2247,78,84
1264,2560,2560,JPEG,RGB,False,1,4f833867-273e-4d73-8bc3-cb2d9ceb54ef.jpg,Airplane,1231,1295,1532,1607,64,75
1265,2560,2560,JPEG,RGB,False,1,4f833867-273e-4d73-8bc3-cb2d9ceb54ef.jpg,Airplane,740,804,1268,1356,64,88
1266,2560,2560,JPEG,RGB,False,1,4f833867-273e-4d73-8bc3-cb2d9ceb54ef.jpg,Airplane,645,730,1399,1458,85,59
1267,2560,2560,JPEG,RGB,False,1,2314c1b5-ec8f-4212-b42f-43365a13fd20.jpg,Airplane,1748,1870,27,178,122,151
1268,2560,2560,JPEG,RGB,False,1,2314c1b5-ec8f-4212-b42f-43365a13fd20.jpg,Airplane,2057,2193,284,434,136,150
1269,2560,2560,JPEG,RGB,False,1,2314c1b5-ec8f-4212-b42f-43365a13fd20.jpg,Truncated_airplane,1570,1695,0,73,125,73
1270,2560,2560,JPEG,RGB,False,1,2314c1b5-ec8f-4212-b42f-43365a13fd20.jpg,Truncated_airplane,1602,1724,2513,2559,122,46
1271,2560,2560,JPEG,RGB,False,1,2314c1b5-ec8f-4212-b42f-43365a13fd20.jpg,Truncated_airplane,738,860,2452,2557,122,105
1272,2560,2560,JPEG,RGB,False,1,2314c1b5-ec8f-4212-b42f-43365a13fd20.jpg,Airplane,238,318,442,509,80,67
1273,2560,2560,JPEG,RGB,False,1,2314c1b5-ec8f-4212-b42f-43365a13fd20.jpg,Airplane,581,727,649,764,146,115
1274,2560,2560,JPEG,RGB,False,1,2314c1b5-ec8f-4212-b42f-43365a13fd20.jpg,Airplane,900,980,843,922,80,79
1275,2560,2560,JPEG,RGB,False,1,2314c1b5-ec8f-4212-b42f-43365a13fd20.jpg,Airplane,1174,1312,1010,1135,138,125
1276,2560,2560,JPEG,RGB,False,1,2314c1b5-ec8f-4212-b42f-43365a13fd20.jpg,Airplane,1532,1609,1239,1302,77,63
1277,2560,2560,JPEG,RGB,False,1,2314c1b5-ec8f-4212-b42f-43365a13fd20.jpg,Airplane,1724,1837,1041,1155,113,114
1278,2560,2560,JPEG,RGB,False,1,2314c1b5-ec8f-4212-b42f-43365a13fd20.jpg,Airplane,1780,1907,1289,1415,127,126
1279,2560,2560,JPEG,RGB,False,1,2314c1b5-ec8f-4212-b42f-43365a13fd20.jpg,Airplane,1923,2075,1377,1517,152,140
1280,2560,2560,JPEG,RGB,False,1,2314c1b5-ec8f-4212-b42f-43365a13fd20.jpg,Airplane,2168,2313,1617,1744,145,127
1281,2560,2560,JPEG,RGB,False,1,2314c1b5-ec8f-4212-b42f-43365a13fd20.jpg,Airplane,1958,2091,2236,2368,133,132
1282,2560,2560,JPEG,RGB,False,1,2314c1b5-ec8f-4212-b42f-43365a13fd20.jpg,Airplane,823,940,2051,2189,117,138
1283,2560,2560,JPEG,RGB,False,1,2314c1b5-ec8f-4212-b42f-43365a13fd20.jpg,Airplane,684,802,1975,2095,118,120
1284,2560,2560,JPEG,RGB,False,1,2314c1b5-ec8f-4212-b42f-43365a13fd20.jpg,Airplane,262,393,1699,1839,131,140
1285,2560,2560,JPEG,RGB,False,1,2314c1b5-ec8f-4212-b42f-43365a13fd20.jpg,Airplane,163,297,2106,2257,134,151
1286,2560,2560,JPEG,RGB,False,1,2314c1b5-ec8f-4212-b42f-43365a13fd20.jpg,Airplane,2259,2361,393,519,102,126
1287,2560,2560,JPEG,RGB,False,1,fc8f9dc5-b6a2-49f3-9bde-1f8ff382ca5f.jpg,Airplane,1513,1664,123,259,151,136
1288,2560,2560,JPEG,RGB,False,1,fc8f9dc5-b6a2-49f3-9bde-1f8ff382ca5f.jpg,Airplane,2267,2329,214,294,62,80
1289,2560,2560,JPEG,RGB,False,1,fc8f9dc5-b6a2-49f3-9bde-1f8ff382ca5f.jpg,Airplane,1900,2035,657,825,135,168
1290,2560,2560,JPEG,RGB,False,1,fc8f9dc5-b6a2-49f3-9bde-1f8ff382ca5f.jpg,Airplane,1708,1888,655,837,180,182
1291,2560,2560,JPEG,RGB,False,1,fc8f9dc5-b6a2-49f3-9bde-1f8ff382ca5f.jpg,Airplane,1492,1566,485,565,74,80
1292,2560,2560,JPEG,RGB,False,1,fc8f9dc5-b6a2-49f3-9bde-1f8ff382ca5f.jpg,Airplane,1385,1468,521,614,83,93
1293,2560,2560,JPEG,RGB,False,1,fc8f9dc5-b6a2-49f3-9bde-1f8ff382ca5f.jpg,Airplane,1263,1429,970,1137,166,167
1294,2560,2560,JPEG,RGB,False,1,fc8f9dc5-b6a2-49f3-9bde-1f8ff382ca5f.jpg,Airplane,1334,1491,1138,1286,157,148
1295,2560,2560,JPEG,RGB,False,1,fc8f9dc5-b6a2-49f3-9bde-1f8ff382ca5f.jpg,Airplane,1027,1119,1268,1346,92,78
1296,2560,2560,JPEG,RGB,False,1,fc8f9dc5-b6a2-49f3-9bde-1f8ff382ca5f.jpg,Airplane,1387,1504,1320,1420,117,100
1297,2560,2560,JPEG,RGB,False,1,fc8f9dc5-b6a2-49f3-9bde-1f8ff382ca5f.jpg,Airplane,2235,2386,1135,1306,151,171
1298,2560,2560,JPEG,RGB,False,1,fc8f9dc5-b6a2-49f3-9bde-1f8ff382ca5f.jpg,Airplane,1636,1731,1669,1780,95,111
1299,2560,2560,JPEG,RGB,False,1,fc8f9dc5-b6a2-49f3-9bde-1f8ff382ca5f.jpg,Airplane,1825,1996,1880,2027,171,147
1300,2560,2560,JPEG,RGB,False,1,fc8f9dc5-b6a2-49f3-9bde-1f8ff382ca5f.jpg,Airplane,1131,1262,1715,1832,131,117
1301,2560,2560,JPEG,RGB,False,1,fc8f9dc5-b6a2-49f3-9bde-1f8ff382ca5f.jpg,Airplane,1222,1309,2148,2207,87,59
1302,2560,2560,JPEG,RGB,False,1,fc8f9dc5-b6a2-49f3-9bde-1f8ff382ca5f.jpg,Airplane,1462,1548,2048,2106,86,58
1303,2560,2560,JPEG,RGB,False,1,fc8f9dc5-b6a2-49f3-9bde-1f8ff382ca5f.jpg,Airplane,1472,1558,2249,2311,86,62
1304,2560,2560,JPEG,RGB,False,1,fc8f9dc5-b6a2-49f3-9bde-1f8ff382ca5f.jpg,Airplane,1276,1347,2347,2399,71,52
1305,2560,2560,JPEG,RGB,False,1,fc8f9dc5-b6a2-49f3-9bde-1f8ff382ca5f.jpg,Airplane,1491,1561,2386,2435,70,49
1306,2560,2560,JPEG,RGB,False,1,fc8f9dc5-b6a2-49f3-9bde-1f8ff382ca5f.jpg,Airplane,1885,1967,2306,2377,82,71
1307,2560,2560,JPEG,RGB,False,1,fc8f9dc5-b6a2-49f3-9bde-1f8ff382ca5f.jpg,Airplane,603,754,1804,1950,151,146
1308,2560,2560,JPEG,RGB,False,1,fc8f9dc5-b6a2-49f3-9bde-1f8ff382ca5f.jpg,Airplane,203,315,1015,1106,112,91
1309,2560,2560,JPEG,RGB,False,1,fc8f9dc5-b6a2-49f3-9bde-1f8ff382ca5f.jpg,Airplane,204,284,1299,1382,80,83
1310,2560,2560,JPEG,RGB,False,1,fc8f9dc5-b6a2-49f3-9bde-1f8ff382ca5f.jpg,Airplane,240,369,1572,1687,129,115
1311,2560,2560,JPEG,RGB,False,1,fc8f9dc5-b6a2-49f3-9bde-1f8ff382ca5f.jpg,Airplane,84,194,1627,1722,110,95
1312,2560,2560,JPEG,RGB,False,1,fc8f9dc5-b6a2-49f3-9bde-1f8ff382ca5f.jpg,Airplane,226,377,1724,1865,151,141
1313,2560,2560,JPEG,RGB,False,1,fc8f9dc5-b6a2-49f3-9bde-1f8ff382ca5f.jpg,Airplane,184,326,2147,2265,142,118
1314,2560,2560,JPEG,RGB,False,1,fc8f9dc5-b6a2-49f3-9bde-1f8ff382ca5f.jpg,Truncated_airplane,0,32,1013,1064,32,51
1315,2560,2560,JPEG,RGB,False,1,fc8f9dc5-b6a2-49f3-9bde-1f8ff382ca5f.jpg,Airplane,1251,1329,2216,2272,78,56
1316,2560,2560,JPEG,RGB,False,1,014de911-7810-4f7d-8967-3e5402209f4a.jpg,Airplane,2404,2493,35,102,89,67
1317,2560,2560,JPEG,RGB,False,1,014de911-7810-4f7d-8967-3e5402209f4a.jpg,Airplane,2388,2475,114,196,87,82
1318,2560,2560,JPEG,RGB,False,1,014de911-7810-4f7d-8967-3e5402209f4a.jpg,Airplane,2353,2422,195,271,69,76
1319,2560,2560,JPEG,RGB,False,1,014de911-7810-4f7d-8967-3e5402209f4a.jpg,Airplane,2270,2344,222,302,74,80
1320,2560,2560,JPEG,RGB,False,1,014de911-7810-4f7d-8967-3e5402209f4a.jpg,Airplane,2124,2211,140,213,87,73
1321,2560,2560,JPEG,RGB,False,1,014de911-7810-4f7d-8967-3e5402209f4a.jpg,Truncated_airplane,2514,2560,645,722,46,77
1322,2560,2560,JPEG,RGB,False,1,014de911-7810-4f7d-8967-3e5402209f4a.jpg,Airplane,1811,1981,299,486,170,187
1323,2560,2560,JPEG,RGB,False,1,014de911-7810-4f7d-8967-3e5402209f4a.jpg,Airplane,2009,2175,608,767,166,159
1324,2560,2560,JPEG,RGB,False,1,014de911-7810-4f7d-8967-3e5402209f4a.jpg,Airplane,1914,2046,666,837,132,171
1325,2560,2560,JPEG,RGB,False,1,014de911-7810-4f7d-8967-3e5402209f4a.jpg,Airplane,1715,1894,668,846,179,178
1326,2560,2560,JPEG,RGB,False,1,014de911-7810-4f7d-8967-3e5402209f4a.jpg,Airplane,1572,1708,585,735,136,150
1327,2560,2560,JPEG,RGB,False,1,014de911-7810-4f7d-8967-3e5402209f4a.jpg,Airplane,1395,1477,542,624,82,82
1328,2560,2560,JPEG,RGB,False,1,014de911-7810-4f7d-8967-3e5402209f4a.jpg,Airplane,1272,1375,787,867,103,80
1329,2560,2560,JPEG,RGB,False,1,014de911-7810-4f7d-8967-3e5402209f4a.jpg,Airplane,2183,2340,995,1153,157,158
1330,2560,2560,JPEG,RGB,False,1,014de911-7810-4f7d-8967-3e5402209f4a.jpg,Airplane,1854,1933,1429,1515,79,86
1331,2560,2560,JPEG,RGB,False,1,014de911-7810-4f7d-8967-3e5402209f4a.jpg,Airplane,1264,1440,981,1151,176,170
1332,2560,2560,JPEG,RGB,False,1,014de911-7810-4f7d-8967-3e5402209f4a.jpg,Airplane,1409,1528,1462,1557,119,95
1333,2560,2560,JPEG,RGB,False,1,014de911-7810-4f7d-8967-3e5402209f4a.jpg,Airplane,1470,1537,2134,2184,67,50
1334,2560,2560,JPEG,RGB,False,1,014de911-7810-4f7d-8967-3e5402209f4a.jpg,Airplane,912,1064,1308,1443,152,135
1335,2560,2560,JPEG,RGB,False,1,014de911-7810-4f7d-8967-3e5402209f4a.jpg,Airplane,1102,1219,1422,1512,117,90
1336,2560,2560,JPEG,RGB,False,1,014de911-7810-4f7d-8967-3e5402209f4a.jpg,Airplane,1136,1248,1578,1677,112,99
1337,2560,2560,JPEG,RGB,False,1,014de911-7810-4f7d-8967-3e5402209f4a.jpg,Airplane,618,745,1827,1945,127,118
1338,2560,2560,JPEG,RGB,False,1,014de911-7810-4f7d-8967-3e5402209f4a.jpg,Airplane,251,385,1746,1863,134,117
1339,2560,2560,JPEG,RGB,False,1,014de911-7810-4f7d-8967-3e5402209f4a.jpg,Airplane,160,250,1494,1554,90,60
1340,2560,2560,JPEG,RGB,False,1,014de911-7810-4f7d-8967-3e5402209f4a.jpg,Airplane,210,289,1328,1386,79,58
1341,2560,2560,JPEG,RGB,False,1,014de911-7810-4f7d-8967-3e5402209f4a.jpg,Airplane,211,303,1172,1247,92,75
1342,2560,2560,JPEG,RGB,False,1,014de911-7810-4f7d-8967-3e5402209f4a.jpg,Airplane,224,301,1054,1099,77,45
1343,2560,2560,JPEG,RGB,False,1,014de911-7810-4f7d-8967-3e5402209f4a.jpg,Airplane,328,434,945,1027,106,82
1344,2560,2560,JPEG,RGB,False,1,014de911-7810-4f7d-8967-3e5402209f4a.jpg,Airplane,765,850,741,814,85,73
1345,2560,2560,JPEG,RGB,False,1,014de911-7810-4f7d-8967-3e5402209f4a.jpg,Airplane,1254,1327,2161,2221,73,60
1346,2560,2560,JPEG,RGB,False,1,014de911-7810-4f7d-8967-3e5402209f4a.jpg,Airplane,1275,1357,2294,2345,82,51
1347,2560,2560,JPEG,RGB,False,1,014de911-7810-4f7d-8967-3e5402209f4a.jpg,Airplane,1505,1580,2455,2506,75,51
1348,2560,2560,JPEG,RGB,False,1,27cd32ba-c86a-419f-b544-601dd67c5d36.jpg,Airplane,1165,1278,161,289,113,128
1349,2560,2560,JPEG,RGB,False,1,27cd32ba-c86a-419f-b544-601dd67c5d36.jpg,Airplane,808,931,106,206,123,100
1350,2560,2560,JPEG,RGB,False,1,27cd32ba-c86a-419f-b544-601dd67c5d36.jpg,Airplane,1204,1383,305,437,179,132
1351,2560,2560,JPEG,RGB,False,1,27cd32ba-c86a-419f-b544-601dd67c5d36.jpg,Airplane,1226,1358,459,619,132,160
1352,2560,2560,JPEG,RGB,False,1,27cd32ba-c86a-419f-b544-601dd67c5d36.jpg,Airplane,1100,1223,550,693,123,143
1353,2560,2560,JPEG,RGB,False,1,27cd32ba-c86a-419f-b544-601dd67c5d36.jpg,Airplane,974,1082,632,766,108,134
1354,2560,2560,JPEG,RGB,False,1,27cd32ba-c86a-419f-b544-601dd67c5d36.jpg,Airplane,840,952,710,840,112,130
1355,2560,2560,JPEG,RGB,False,1,27cd32ba-c86a-419f-b544-601dd67c5d36.jpg,Airplane,551,668,889,1014,117,125
1356,2560,2560,JPEG,RGB,False,1,27cd32ba-c86a-419f-b544-601dd67c5d36.jpg,Airplane,439,537,985,1090,98,105
1357,2560,2560,JPEG,RGB,False,1,27cd32ba-c86a-419f-b544-601dd67c5d36.jpg,Airplane,1185,1324,1123,1255,139,132
1358,2560,2560,JPEG,RGB,False,1,27cd32ba-c86a-419f-b544-601dd67c5d36.jpg,Airplane,1266,1414,1258,1391,148,133
1359,2560,2560,JPEG,RGB,False,1,27cd32ba-c86a-419f-b544-601dd67c5d36.jpg,Airplane,1529,1682,1039,1165,153,126
1360,2560,2560,JPEG,RGB,False,1,27cd32ba-c86a-419f-b544-601dd67c5d36.jpg,Airplane,2186,2253,780,862,67,82
1361,2560,2560,JPEG,RGB,False,1,27cd32ba-c86a-419f-b544-601dd67c5d36.jpg,Airplane,1600,1711,1397,1526,111,129
1362,2560,2560,JPEG,RGB,False,1,27cd32ba-c86a-419f-b544-601dd67c5d36.jpg,Airplane,1902,2050,1607,1716,148,109
1363,2560,2560,JPEG,RGB,False,1,27cd32ba-c86a-419f-b544-601dd67c5d36.jpg,Airplane,2093,2255,1471,1607,162,136
1364,2560,2560,JPEG,RGB,False,1,27cd32ba-c86a-419f-b544-601dd67c5d36.jpg,Airplane,2364,2491,1696,1857,127,161
1365,2560,2560,JPEG,RGB,False,1,27cd32ba-c86a-419f-b544-601dd67c5d36.jpg,Airplane,2376,2469,1977,2095,93,118
1366,2560,2560,JPEG,RGB,False,1,27cd32ba-c86a-419f-b544-601dd67c5d36.jpg,Airplane,2225,2338,2048,2168,113,120
1367,2560,2560,JPEG,RGB,False,1,27cd32ba-c86a-419f-b544-601dd67c5d36.jpg,Airplane,1716,1847,2142,2271,131,129
1368,2560,2560,JPEG,RGB,False,1,27cd32ba-c86a-419f-b544-601dd67c5d36.jpg,Airplane,1843,1921,2305,2366,78,61
1369,2560,2560,JPEG,RGB,False,1,27cd32ba-c86a-419f-b544-601dd67c5d36.jpg,Airplane,1580,1701,1789,1914,121,125
1370,2560,2560,JPEG,RGB,False,1,27cd32ba-c86a-419f-b544-601dd67c5d36.jpg,Airplane,1497,1640,1665,1797,143,132
1371,2560,2560,JPEG,RGB,False,1,27cd32ba-c86a-419f-b544-601dd67c5d36.jpg,Airplane,1421,1564,1548,1669,143,121
1372,2560,2560,JPEG,RGB,False,1,27cd32ba-c86a-419f-b544-601dd67c5d36.jpg,Airplane,1981,2133,1738,1843,152,105
1373,2560,2560,JPEG,RGB,False,1,56765c5f-0922-43b3-8d58-bf2bf5a1e727.jpg,Airplane,1199,1318,413,533,119,120
1374,2560,2560,JPEG,RGB,False,1,56765c5f-0922-43b3-8d58-bf2bf5a1e727.jpg,Airplane,1008,1071,587,638,63,51
1375,2560,2560,JPEG,RGB,False,1,56765c5f-0922-43b3-8d58-bf2bf5a1e727.jpg,Airplane,1093,1207,891,1010,114,119
1376,2560,2560,JPEG,RGB,False,1,56765c5f-0922-43b3-8d58-bf2bf5a1e727.jpg,Airplane,1045,1175,1020,1138,130,118
1377,2560,2560,JPEG,RGB,False,1,56765c5f-0922-43b3-8d58-bf2bf5a1e727.jpg,Airplane,989,1121,1148,1266,132,118
1378,2560,2560,JPEG,RGB,False,1,56765c5f-0922-43b3-8d58-bf2bf5a1e727.jpg,Airplane,1164,1243,2187,2268,79,81
1379,2560,2560,JPEG,RGB,False,1,56765c5f-0922-43b3-8d58-bf2bf5a1e727.jpg,Airplane,578,696,2235,2363,118,128
1380,2560,2560,JPEG,RGB,False,1,56765c5f-0922-43b3-8d58-bf2bf5a1e727.jpg,Airplane,492,621,1923,2030,129,107
1381,2560,2560,JPEG,RGB,False,1,56765c5f-0922-43b3-8d58-bf2bf5a1e727.jpg,Airplane,483,553,2074,2134,70,60
1382,2560,2560,JPEG,RGB,False,1,56765c5f-0922-43b3-8d58-bf2bf5a1e727.jpg,Airplane,130,276,2090,2208,146,118
1383,2560,2560,JPEG,RGB,False,1,56765c5f-0922-43b3-8d58-bf2bf5a1e727.jpg,Airplane,101,242,2214,2329,141,115
1384,2560,2560,JPEG,RGB,False,1,56765c5f-0922-43b3-8d58-bf2bf5a1e727.jpg,Airplane,63,210,2347,2471,147,124
1385,2560,2560,JPEG,RGB,False,1,56765c5f-0922-43b3-8d58-bf2bf5a1e727.jpg,Airplane,1020,1092,3,65,72,62
1386,2560,2560,JPEG,RGB,False,1,56765c5f-0922-43b3-8d58-bf2bf5a1e727.jpg,Airplane,986,1056,134,197,70,63
1387,2560,2560,JPEG,RGB,False,1,56765c5f-0922-43b3-8d58-bf2bf5a1e727.jpg,Airplane,942,1018,195,261,76,66
1388,2560,2560,JPEG,RGB,False,1,56765c5f-0922-43b3-8d58-bf2bf5a1e727.jpg,Airplane,908,980,323,395,72,72
1389,2560,2560,JPEG,RGB,False,1,56765c5f-0922-43b3-8d58-bf2bf5a1e727.jpg,Airplane,918,984,397,463,66,66
1390,2560,2560,JPEG,RGB,False,1,56765c5f-0922-43b3-8d58-bf2bf5a1e727.jpg,Airplane,879,955,455,520,76,65
1391,2560,2560,JPEG,RGB,False,1,56765c5f-0922-43b3-8d58-bf2bf5a1e727.jpg,Airplane,858,917,665,725,59,60
1392,2560,2560,JPEG,RGB,False,1,56765c5f-0922-43b3-8d58-bf2bf5a1e727.jpg,Airplane,819,892,756,820,73,64
1393,2560,2560,JPEG,RGB,False,1,56765c5f-0922-43b3-8d58-bf2bf5a1e727.jpg,Airplane,863,898,841,879,35,38
1394,2560,2560,JPEG,RGB,False,1,56765c5f-0922-43b3-8d58-bf2bf5a1e727.jpg,Airplane,668,740,1341,1406,72,65
1395,2560,2560,JPEG,RGB,False,1,56765c5f-0922-43b3-8d58-bf2bf5a1e727.jpg,Airplane,369,443,2446,2507,74,61
1396,2560,2560,JPEG,RGB,False,1,56765c5f-0922-43b3-8d58-bf2bf5a1e727.jpg,Airplane,170,243,1720,1796,73,76
1397,2560,2560,JPEG,RGB,False,1,d0c3d270-f23e-4792-bac0-142a9cc8ccc6.jpg,Airplane,2250,2359,382,505,109,123
1398,2560,2560,JPEG,RGB,False,1,d0c3d270-f23e-4792-bac0-142a9cc8ccc6.jpg,Airplane,2048,2191,270,436,143,166
1399,2560,2560,JPEG,RGB,False,1,d0c3d270-f23e-4792-bac0-142a9cc8ccc6.jpg,Airplane,1834,1917,993,1074,83,81
1400,2560,2560,JPEG,RGB,False,1,d0c3d270-f23e-4792-bac0-142a9cc8ccc6.jpg,Airplane,1730,1867,16,168,137,152
1401,2560,2560,JPEG,RGB,False,1,d0c3d270-f23e-4792-bac0-142a9cc8ccc6.jpg,Airplane,1604,1735,25,181,131,156
1402,2560,2560,JPEG,RGB,False,1,d0c3d270-f23e-4792-bac0-142a9cc8ccc6.jpg,Truncated_airplane,1558,1680,0,69,122,69
1403,2560,2560,JPEG,RGB,False,1,d0c3d270-f23e-4792-bac0-142a9cc8ccc6.jpg,Airplane,1828,1896,1263,1346,68,83
1404,2560,2560,JPEG,RGB,False,1,d0c3d270-f23e-4792-bac0-142a9cc8ccc6.jpg,Airplane,1925,2050,1377,1526,125,149
1405,2560,2560,JPEG,RGB,False,1,d0c3d270-f23e-4792-bac0-142a9cc8ccc6.jpg,Airplane,128,281,1401,1519,153,118
1406,2560,2560,JPEG,RGB,False,1,d0c3d270-f23e-4792-bac0-142a9cc8ccc6.jpg,Airplane,541,660,1862,2008,119,146
1407,2560,2560,JPEG,RGB,False,1,d0c3d270-f23e-4792-bac0-142a9cc8ccc6.jpg,Airplane,679,821,1939,2089,142,150
1408,2560,2560,JPEG,RGB,False,1,d0c3d270-f23e-4792-bac0-142a9cc8ccc6.jpg,Airplane,254,400,1687,1831,146,144
1409,2560,2560,JPEG,RGB,False,1,d0c3d270-f23e-4792-bac0-142a9cc8ccc6.jpg,Airplane,90,204,1587,1718,114,131
1410,2560,2560,JPEG,RGB,False,1,d0c3d270-f23e-4792-bac0-142a9cc8ccc6.jpg,Airplane,455,571,2273,2415,116,142
1411,2560,2560,JPEG,RGB,False,1,d0c3d270-f23e-4792-bac0-142a9cc8ccc6.jpg,Airplane,597,711,2360,2496,114,136
1412,2560,2560,JPEG,RGB,False,1,d0c3d270-f23e-4792-bac0-142a9cc8ccc6.jpg,Airplane,0,128,1996,2160,128,164
1413,2560,2560,JPEG,RGB,False,1,77f7b57f-5cf2-424d-a952-9847b3c3f35e.jpg,Airplane,2393,2478,41,99,85,58
1414,2560,2560,JPEG,RGB,False,1,77f7b57f-5cf2-424d-a952-9847b3c3f35e.jpg,Airplane,2382,2462,125,193,80,68
1415,2560,2560,JPEG,RGB,False,1,77f7b57f-5cf2-424d-a952-9847b3c3f35e.jpg,Airplane,2117,2198,139,223,81,84
1416,2560,2560,JPEG,RGB,False,1,77f7b57f-5cf2-424d-a952-9847b3c3f35e.jpg,Airplane,1634,1774,241,375,140,134
1417,2560,2560,JPEG,RGB,False,1,77f7b57f-5cf2-424d-a952-9847b3c3f35e.jpg,Airplane,1809,1979,303,488,170,185
1418,2560,2560,JPEG,RGB,False,1,77f7b57f-5cf2-424d-a952-9847b3c3f35e.jpg,Airplane,1403,1544,500,641,141,141
1419,2560,2560,JPEG,RGB,False,1,77f7b57f-5cf2-424d-a952-9847b3c3f35e.jpg,Airplane,2213,2301,781,863,88,82
1420,2560,2560,JPEG,RGB,False,1,77f7b57f-5cf2-424d-a952-9847b3c3f35e.jpg,Airplane,2175,2339,995,1159,164,164
1421,2560,2560,JPEG,RGB,False,1,77f7b57f-5cf2-424d-a952-9847b3c3f35e.jpg,Airplane,2033,2172,1077,1240,139,163
1422,2560,2560,JPEG,RGB,False,1,77f7b57f-5cf2-424d-a952-9847b3c3f35e.jpg,Airplane,1960,2048,1199,1287,88,88
1423,2560,2560,JPEG,RGB,False,1,77f7b57f-5cf2-424d-a952-9847b3c3f35e.jpg,Airplane,2182,2340,1383,1522,158,139
1424,2560,2560,JPEG,RGB,False,1,77f7b57f-5cf2-424d-a952-9847b3c3f35e.jpg,Airplane,754,850,737,818,96,81
1425,2560,2560,JPEG,RGB,False,1,77f7b57f-5cf2-424d-a952-9847b3c3f35e.jpg,Airplane,212,304,1052,1119,92,67
1426,2560,2560,JPEG,RGB,False,1,77f7b57f-5cf2-424d-a952-9847b3c3f35e.jpg,Airplane,1263,1438,977,1151,175,174
1427,2560,2560,JPEG,RGB,False,1,77f7b57f-5cf2-424d-a952-9847b3c3f35e.jpg,Airplane,1336,1500,1149,1303,164,154
1428,2560,2560,JPEG,RGB,False,1,77f7b57f-5cf2-424d-a952-9847b3c3f35e.jpg,Airplane,1830,1984,1895,2034,154,139
1429,2560,2560,JPEG,RGB,False,1,77f7b57f-5cf2-424d-a952-9847b3c3f35e.jpg,Airplane,1419,1535,1464,1558,116,94
1430,2560,2560,JPEG,RGB,False,1,77f7b57f-5cf2-424d-a952-9847b3c3f35e.jpg,Airplane,1108,1243,1571,1691,135,120
1431,2560,2560,JPEG,RGB,False,1,77f7b57f-5cf2-424d-a952-9847b3c3f35e.jpg,Airplane,580,708,1686,1783,128,97
1432,2560,2560,JPEG,RGB,False,1,77f7b57f-5cf2-424d-a952-9847b3c3f35e.jpg,Airplane,225,380,1740,1869,155,129
1433,2560,2560,JPEG,RGB,False,1,77f7b57f-5cf2-424d-a952-9847b3c3f35e.jpg,Airplane,623,776,1980,2111,153,131
1434,2560,2560,JPEG,RGB,False,1,77f7b57f-5cf2-424d-a952-9847b3c3f35e.jpg,Airplane,1456,1547,2118,2198,91,80
1435,2560,2560,JPEG,RGB,False,1,77f7b57f-5cf2-424d-a952-9847b3c3f35e.jpg,Airplane,1451,1559,2200,2263,108,63
1436,2560,2560,JPEG,RGB,False,1,77f7b57f-5cf2-424d-a952-9847b3c3f35e.jpg,Airplane,1468,1549,2265,2332,81,67
1437,2560,2560,JPEG,RGB,False,1,77f7b57f-5cf2-424d-a952-9847b3c3f35e.jpg,Airplane,1482,1576,2392,2458,94,66
1438,2560,2560,JPEG,RGB,False,1,77f7b57f-5cf2-424d-a952-9847b3c3f35e.jpg,Airplane,1470,1579,2450,2517,109,67
1439,2560,2560,JPEG,RGB,False,1,77f7b57f-5cf2-424d-a952-9847b3c3f35e.jpg,Airplane,1249,1349,2290,2356,100,66
1440,2560,2560,JPEG,RGB,False,1,77f7b57f-5cf2-424d-a952-9847b3c3f35e.jpg,Airplane,1260,1358,2356,2423,98,67
1441,2560,2560,JPEG,RGB,False,1,77f7b57f-5cf2-424d-a952-9847b3c3f35e.jpg,Airplane,1125,1272,1731,1854,147,123
1442,2560,2560,JPEG,RGB,False,1,77f7b57f-5cf2-424d-a952-9847b3c3f35e.jpg,Airplane,1144,1285,1869,1992,141,123
1443,2560,2560,JPEG,RGB,False,1,77f7b57f-5cf2-424d-a952-9847b3c3f35e.jpg,Truncated_airplane,0,32,1022,1079,32,57
1444,2560,2560,JPEG,RGB,False,1,5f726a3d-9876-498f-90c5-9f9efae06c6a.jpg,Airplane,2258,2319,2188,2256,61,68
1445,2560,2560,JPEG,RGB,False,1,5f726a3d-9876-498f-90c5-9f9efae06c6a.jpg,Airplane,2503,2554,2361,2424,51,63
1446,2560,2560,JPEG,RGB,False,1,5f726a3d-9876-498f-90c5-9f9efae06c6a.jpg,Airplane,2385,2441,2198,2251,56,53
1447,2560,2560,JPEG,RGB,False,1,5f726a3d-9876-498f-90c5-9f9efae06c6a.jpg,Airplane,2451,2514,2020,2105,63,85
1448,2560,2560,JPEG,RGB,False,1,5f726a3d-9876-498f-90c5-9f9efae06c6a.jpg,Truncated_airplane,2537,2564,2031,2101,27,70
1449,2560,2560,JPEG,RGB,False,1,5f726a3d-9876-498f-90c5-9f9efae06c6a.jpg,Airplane,2237,2300,2033,2097,63,64
1450,2560,2560,JPEG,RGB,False,1,5f726a3d-9876-498f-90c5-9f9efae06c6a.jpg,Airplane,1787,1874,2443,2514,87,71
1451,2560,2560,JPEG,RGB,False,1,5f726a3d-9876-498f-90c5-9f9efae06c6a.jpg,Airplane,2469,2537,1220,1281,68,61
1452,2560,2560,JPEG,RGB,False,1,5f726a3d-9876-498f-90c5-9f9efae06c6a.jpg,Airplane,2082,2140,1136,1185,58,49
1453,2560,2560,JPEG,RGB,False,1,5f726a3d-9876-498f-90c5-9f9efae06c6a.jpg,Airplane,2019,2080,1078,1141,61,63
1454,2560,2560,JPEG,RGB,False,1,5f726a3d-9876-498f-90c5-9f9efae06c6a.jpg,Airplane,2310,2395,734,802,85,68
1455,2560,2560,JPEG,RGB,False,1,5f726a3d-9876-498f-90c5-9f9efae06c6a.jpg,Airplane,2379,2449,664,746,70,82
1456,2560,2560,JPEG,RGB,False,1,5f726a3d-9876-498f-90c5-9f9efae06c6a.jpg,Airplane,1870,1915,1024,1092,45,68
1457,2560,2560,JPEG,RGB,False,1,5f726a3d-9876-498f-90c5-9f9efae06c6a.jpg,Airplane,1723,1783,720,796,60,76
1458,2560,2560,JPEG,RGB,False,1,5f726a3d-9876-498f-90c5-9f9efae06c6a.jpg,Airplane,1877,1949,712,791,72,79
1459,2560,2560,JPEG,RGB,False,1,5f726a3d-9876-498f-90c5-9f9efae06c6a.jpg,Airplane,1967,2035,693,783,68,90
1460,2560,2560,JPEG,RGB,False,1,5f726a3d-9876-498f-90c5-9f9efae06c6a.jpg,Airplane,2154,2239,561,625,85,64
1461,2560,2560,JPEG,RGB,False,1,5f726a3d-9876-498f-90c5-9f9efae06c6a.jpg,Airplane,2227,2297,496,557,70,61
1462,2560,2560,JPEG,RGB,False,1,5f726a3d-9876-498f-90c5-9f9efae06c6a.jpg,Airplane,2329,2407,338,410,78,72
1463,2560,2560,JPEG,RGB,False,1,5f726a3d-9876-498f-90c5-9f9efae06c6a.jpg,Truncated_airplane,2497,2560,391,458,63,67
1464,2560,2560,JPEG,RGB,False,1,5f726a3d-9876-498f-90c5-9f9efae06c6a.jpg,Truncated_airplane,2485,2555,522,588,70,66
1465,2560,2560,JPEG,RGB,False,1,5f726a3d-9876-498f-90c5-9f9efae06c6a.jpg,Airplane,2322,2393,240,305,71,65
1466,2560,2560,JPEG,RGB,False,1,5f726a3d-9876-498f-90c5-9f9efae06c6a.jpg,Airplane,2386,2465,172,241,79,69
1467,2560,2560,JPEG,RGB,False,1,5f726a3d-9876-498f-90c5-9f9efae06c6a.jpg,Airplane,1598,1673,2351,2419,75,68
1468,2560,2560,JPEG,RGB,False,1,5f726a3d-9876-498f-90c5-9f9efae06c6a.jpg,Truncated_airplane,0,29,1971,2039,29,68
1469,2560,2560,JPEG,RGB,False,1,5f726a3d-9876-498f-90c5-9f9efae06c6a.jpg,Airplane,138,168,1976,2015,30,39
1470,2560,2560,JPEG,RGB,False,1,5f726a3d-9876-498f-90c5-9f9efae06c6a.jpg,Airplane,309,466,751,917,157,166
1471,2560,2560,JPEG,RGB,False,1,5f726a3d-9876-498f-90c5-9f9efae06c6a.jpg,Airplane,287,357,548,616,70,68
1472,2560,2560,JPEG,RGB,False,1,5f726a3d-9876-498f-90c5-9f9efae06c6a.jpg,Airplane,547,600,631,705,53,74
1473,2560,2560,JPEG,RGB,False,1,5f726a3d-9876-498f-90c5-9f9efae06c6a.jpg,Airplane,1028,1089,609,685,61,76
1474,2560,2560,JPEG,RGB,False,1,5f726a3d-9876-498f-90c5-9f9efae06c6a.jpg,Airplane,819,892,930,1010,73,80
1475,2560,2560,JPEG,RGB,False,1,5f726a3d-9876-498f-90c5-9f9efae06c6a.jpg,Airplane,330,406,452,525,76,73
1476,2560,2560,JPEG,RGB,False,1,5f726a3d-9876-498f-90c5-9f9efae06c6a.jpg,Airplane,327,407,364,432,80,68
1477,2560,2560,JPEG,RGB,False,1,5f726a3d-9876-498f-90c5-9f9efae06c6a.jpg,Airplane,333,412,275,352,79,77
1478,2560,2560,JPEG,RGB,False,1,ecfe7982-05e5-435f-824b-e24b6846316e.jpg,Truncated_airplane,1850,1913,2,34,63,32
1479,2560,2560,JPEG,RGB,False,1,ecfe7982-05e5-435f-824b-e24b6846316e.jpg,Truncated_airplane,1743,1796,0,44,53,44
1480,2560,2560,JPEG,RGB,False,1,ecfe7982-05e5-435f-824b-e24b6846316e.jpg,Airplane,1771,1858,404,495,87,91
1481,2560,2560,JPEG,RGB,False,1,ecfe7982-05e5-435f-824b-e24b6846316e.jpg,Airplane,1374,1463,391,494,89,103
1482,2560,2560,JPEG,RGB,False,1,ecfe7982-05e5-435f-824b-e24b6846316e.jpg,Airplane,1192,1278,398,485,86,87
1483,2560,2560,JPEG,RGB,False,1,ecfe7982-05e5-435f-824b-e24b6846316e.jpg,Airplane,893,973,392,490,80,98
1484,2560,2560,JPEG,RGB,False,1,ecfe7982-05e5-435f-824b-e24b6846316e.jpg,Airplane,790,880,398,492,90,94
1485,2560,2560,JPEG,RGB,False,1,ecfe7982-05e5-435f-824b-e24b6846316e.jpg,Airplane,1784,1868,661,758,84,97
1486,2560,2560,JPEG,RGB,False,1,ecfe7982-05e5-435f-824b-e24b6846316e.jpg,Airplane,1593,1672,710,788,79,78
1487,2560,2560,JPEG,RGB,False,1,ecfe7982-05e5-435f-824b-e24b6846316e.jpg,Airplane,1377,1455,704,797,78,93
1488,2560,2560,JPEG,RGB,False,1,ecfe7982-05e5-435f-824b-e24b6846316e.jpg,Airplane,1277,1362,650,748,85,98
1489,2560,2560,JPEG,RGB,False,1,ecfe7982-05e5-435f-824b-e24b6846316e.jpg,Airplane,1191,1263,658,749,72,91
1490,2560,2560,JPEG,RGB,False,1,ecfe7982-05e5-435f-824b-e24b6846316e.jpg,Airplane,403,483,1400,1504,80,104
1491,2560,2560,JPEG,RGB,False,1,ecfe7982-05e5-435f-824b-e24b6846316e.jpg,Airplane,490,569,1399,1510,79,111
1492,2560,2560,JPEG,RGB,False,1,ecfe7982-05e5-435f-824b-e24b6846316e.jpg,Airplane,1330,1410,1414,1513,80,99
1493,2560,2560,JPEG,RGB,False,1,ecfe7982-05e5-435f-824b-e24b6846316e.jpg,Airplane,1195,1272,1418,1518,77,100
1494,2560,2560,JPEG,RGB,False,1,ecfe7982-05e5-435f-824b-e24b6846316e.jpg,Airplane,1100,1182,1420,1512,82,92
1495,2560,2560,JPEG,RGB,False,1,ecfe7982-05e5-435f-824b-e24b6846316e.jpg,Airplane,988,1066,1413,1516,78,103
1496,2560,2560,JPEG,RGB,False,1,ecfe7982-05e5-435f-824b-e24b6846316e.jpg,Airplane,894,972,1410,1515,78,105
1497,2560,2560,JPEG,RGB,False,1,ecfe7982-05e5-435f-824b-e24b6846316e.jpg,Airplane,792,879,1403,1515,87,112
1498,2560,2560,JPEG,RGB,False,1,ecfe7982-05e5-435f-824b-e24b6846316e.jpg,Airplane,707,785,1394,1507,78,113
1499,2560,2560,JPEG,RGB,False,1,ecfe7982-05e5-435f-824b-e24b6846316e.jpg,Airplane,604,689,1405,1517,85,112
1500,2560,2560,JPEG,RGB,False,1,ecfe7982-05e5-435f-824b-e24b6846316e.jpg,Airplane,2494,2537,1432,1507,43,75
1501,2560,2560,JPEG,RGB,False,1,ecfe7982-05e5-435f-824b-e24b6846316e.jpg,Airplane,2433,2474,1436,1502,41,66
1502,2560,2560,JPEG,RGB,False,1,ecfe7982-05e5-435f-824b-e24b6846316e.jpg,Airplane,2339,2410,1423,1527,71,104
1503,2560,2560,JPEG,RGB,False,1,ecfe7982-05e5-435f-824b-e24b6846316e.jpg,Airplane,2251,2325,1425,1523,74,98
1504,2560,2560,JPEG,RGB,False,1,ecfe7982-05e5-435f-824b-e24b6846316e.jpg,Airplane,2115,2190,1430,1518,75,88
1505,2560,2560,JPEG,RGB,False,1,ecfe7982-05e5-435f-824b-e24b6846316e.jpg,Airplane,2017,2093,1424,1520,76,96
1506,2560,2560,JPEG,RGB,False,1,ecfe7982-05e5-435f-824b-e24b6846316e.jpg,Airplane,1914,2004,1425,1523,90,98
1507,2560,2560,JPEG,RGB,False,1,ecfe7982-05e5-435f-824b-e24b6846316e.jpg,Airplane,1800,1880,1417,1520,80,103
1508,2560,2560,JPEG,RGB,False,1,ecfe7982-05e5-435f-824b-e24b6846316e.jpg,Airplane,1708,1794,1408,1523,86,115
1509,2560,2560,JPEG,RGB,False,1,ecfe7982-05e5-435f-824b-e24b6846316e.jpg,Airplane,1609,1703,1407,1529,94,122
1510,2560,2560,JPEG,RGB,False,1,ecfe7982-05e5-435f-824b-e24b6846316e.jpg,Airplane,2497,2550,1789,1851,53,62
1511,2560,2560,JPEG,RGB,False,1,ecfe7982-05e5-435f-824b-e24b6846316e.jpg,Airplane,2423,2476,1786,1858,53,72
1512,2560,2560,JPEG,RGB,False,1,ecfe7982-05e5-435f-824b-e24b6846316e.jpg,Airplane,2346,2408,1785,1855,62,70
1513,2560,2560,JPEG,RGB,False,1,ecfe7982-05e5-435f-824b-e24b6846316e.jpg,Airplane,2266,2326,1785,1849,60,64
1514,2560,2560,JPEG,RGB,False,1,ecfe7982-05e5-435f-824b-e24b6846316e.jpg,Airplane,2375,2475,2300,2357,100,57
1515,2560,2560,JPEG,RGB,False,1,ecfe7982-05e5-435f-824b-e24b6846316e.jpg,Airplane,2116,2190,1774,1865,74,91
1516,2560,2560,JPEG,RGB,False,1,ecfe7982-05e5-435f-824b-e24b6846316e.jpg,Airplane,2026,2098,1769,1875,72,106
1517,2560,2560,JPEG,RGB,False,1,ecfe7982-05e5-435f-824b-e24b6846316e.jpg,Airplane,1897,1987,1764,1886,90,122
1518,2560,2560,JPEG,RGB,False,1,ecfe7982-05e5-435f-824b-e24b6846316e.jpg,Airplane,1786,1870,1738,1863,84,125
1519,2560,2560,JPEG,RGB,False,1,ecfe7982-05e5-435f-824b-e24b6846316e.jpg,Airplane,1612,1754,1732,1874,142,142
1520,2560,2560,JPEG,RGB,False,1,ecfe7982-05e5-435f-824b-e24b6846316e.jpg,Airplane,1125,1261,1713,1858,136,145
1521,2560,2560,JPEG,RGB,False,1,ecfe7982-05e5-435f-824b-e24b6846316e.jpg,Airplane,1555,1664,1923,2009,109,86
1522,2560,2560,JPEG,RGB,False,1,ecfe7982-05e5-435f-824b-e24b6846316e.jpg,Airplane,1291,1392,1909,2034,101,125
1523,2560,2560,JPEG,RGB,False,1,ecfe7982-05e5-435f-824b-e24b6846316e.jpg,Airplane,1000,1081,1755,1860,81,105
1524,2560,2560,JPEG,RGB,False,1,ecfe7982-05e5-435f-824b-e24b6846316e.jpg,Airplane,808,885,1758,1854,77,96
1525,2560,2560,JPEG,RGB,False,1,ecfe7982-05e5-435f-824b-e24b6846316e.jpg,Airplane,678,756,1749,1840,78,91
1526,2560,2560,JPEG,RGB,False,1,ecfe7982-05e5-435f-824b-e24b6846316e.jpg,Airplane,578,664,1750,1838,86,88
1527,2560,2560,JPEG,RGB,False,1,ecfe7982-05e5-435f-824b-e24b6846316e.jpg,Airplane,485,570,1750,1847,85,97
1528,2560,2560,JPEG,RGB,False,1,ecfe7982-05e5-435f-824b-e24b6846316e.jpg,Airplane,398,487,1762,1847,89,85
1529,2560,2560,JPEG,RGB,False,1,ecfe7982-05e5-435f-824b-e24b6846316e.jpg,Airplane,1886,1957,1141,1192,71,51
1530,2560,2560,JPEG,RGB,False,1,48ef8e15-a43c-406b-9d3c-e815164b96d1.jpg,Airplane,788,886,715,826,98,111
1531,2560,2560,JPEG,RGB,False,1,48ef8e15-a43c-406b-9d3c-e815164b96d1.jpg,Airplane,906,1002,762,872,96,110
1532,2560,2560,JPEG,RGB,False,1,48ef8e15-a43c-406b-9d3c-e815164b96d1.jpg,Airplane,1201,1300,456,566,99,110
1533,2560,2560,JPEG,RGB,False,1,48ef8e15-a43c-406b-9d3c-e815164b96d1.jpg,Airplane,1061,1187,393,521,126,128
1534,2560,2560,JPEG,RGB,False,1,48ef8e15-a43c-406b-9d3c-e815164b96d1.jpg,Airplane,927,1027,356,464,100,108
1535,2560,2560,JPEG,RGB,False,1,48ef8e15-a43c-406b-9d3c-e815164b96d1.jpg,Airplane,819,930,1088,1214,111,126
1536,2560,2560,JPEG,RGB,False,1,48ef8e15-a43c-406b-9d3c-e815164b96d1.jpg,Airplane,1822,1936,343,447,114,104
1537,2560,2560,JPEG,RGB,False,1,48ef8e15-a43c-406b-9d3c-e815164b96d1.jpg,Airplane,2466,2561,238,349,95,111
1538,2560,2560,JPEG,RGB,False,1,48ef8e15-a43c-406b-9d3c-e815164b96d1.jpg,Airplane,1993,2043,756,819,50,63
1539,2560,2560,JPEG,RGB,False,1,48ef8e15-a43c-406b-9d3c-e815164b96d1.jpg,Airplane,2197,2304,829,966,107,137
1540,2560,2560,JPEG,RGB,False,1,48ef8e15-a43c-406b-9d3c-e815164b96d1.jpg,Airplane,2085,2146,1119,1177,61,58
1541,2560,2560,JPEG,RGB,False,1,48ef8e15-a43c-406b-9d3c-e815164b96d1.jpg,Airplane,2058,2119,1185,1243,61,58
1542,2560,2560,JPEG,RGB,False,1,48ef8e15-a43c-406b-9d3c-e815164b96d1.jpg,Airplane,2033,2091,1252,1308,58,56
1543,2560,2560,JPEG,RGB,False,1,48ef8e15-a43c-406b-9d3c-e815164b96d1.jpg,Airplane,1889,1955,1587,1646,66,59
1544,2560,2560,JPEG,RGB,False,1,48ef8e15-a43c-406b-9d3c-e815164b96d1.jpg,Airplane,1811,1867,1790,1851,56,61
1545,2560,2560,JPEG,RGB,False,1,48ef8e15-a43c-406b-9d3c-e815164b96d1.jpg,Airplane,1758,1823,1882,1934,65,52
1546,2560,2560,JPEG,RGB,False,1,48ef8e15-a43c-406b-9d3c-e815164b96d1.jpg,Airplane,1739,1795,1946,1997,56,51
1547,2560,2560,JPEG,RGB,False,1,48ef8e15-a43c-406b-9d3c-e815164b96d1.jpg,Airplane,787,890,709,826,103,117
1548,2560,2560,JPEG,RGB,False,1,48ef8e15-a43c-406b-9d3c-e815164b96d1.jpg,Airplane,906,1001,758,870,95,112
1549,2560,2560,JPEG,RGB,False,1,48ef8e15-a43c-406b-9d3c-e815164b96d1.jpg,Airplane,1197,1299,450,565,102,115
1550,2560,2560,JPEG,RGB,False,1,48ef8e15-a43c-406b-9d3c-e815164b96d1.jpg,Airplane,2199,2308,836,962,109,126
1551,2560,2560,JPEG,RGB,False,1,48ef8e15-a43c-406b-9d3c-e815164b96d1.jpg,Airplane,1990,2047,755,817,57,62
1552,2560,2560,JPEG,RGB,False,1,48ef8e15-a43c-406b-9d3c-e815164b96d1.jpg,Airplane,2082,2154,1116,1175,72,59
1553,2560,2560,JPEG,RGB,False,1,48ef8e15-a43c-406b-9d3c-e815164b96d1.jpg,Airplane,2056,2126,1182,1241,70,59
1554,2560,2560,JPEG,RGB,False,1,48ef8e15-a43c-406b-9d3c-e815164b96d1.jpg,Airplane,2029,2096,1250,1309,67,59
1555,2560,2560,JPEG,RGB,False,1,48ef8e15-a43c-406b-9d3c-e815164b96d1.jpg,Airplane,1888,1953,1586,1646,65,60
1556,2560,2560,JPEG,RGB,False,1,48ef8e15-a43c-406b-9d3c-e815164b96d1.jpg,Airplane,1809,1869,1790,1848,60,58
1557,2560,2560,JPEG,RGB,False,1,48ef8e15-a43c-406b-9d3c-e815164b96d1.jpg,Airplane,1760,1828,1878,1936,68,58
1558,2560,2560,JPEG,RGB,False,1,48ef8e15-a43c-406b-9d3c-e815164b96d1.jpg,Airplane,1736,1794,1946,2000,58,54
1559,2560,2560,JPEG,RGB,False,1,48ef8e15-a43c-406b-9d3c-e815164b96d1.jpg,Airplane,826,931,1087,1216,105,129
1560,2560,2560,JPEG,RGB,False,1,48ef8e15-a43c-406b-9d3c-e815164b96d1.jpg,Airplane,1059,1187,393,522,128,129
1561,2560,2560,JPEG,RGB,False,1,48ef8e15-a43c-406b-9d3c-e815164b96d1.jpg,Airplane,932,1028,355,461,96,106
1562,2560,2560,JPEG,RGB,False,1,48ef8e15-a43c-406b-9d3c-e815164b96d1.jpg,Truncated_airplane,2461,2560,244,345,99,101
1563,2560,2560,JPEG,RGB,False,1,48ef8e15-a43c-406b-9d3c-e815164b96d1.jpg,Airplane,1820,1937,344,443,117,99
1564,2560,2560,JPEG,RGB,False,1,48ef8e15-a43c-406b-9d3c-e815164b96d1.jpg,Truncated_airplane,2239,2336,0,28,97,28
1565,2560,2560,JPEG,RGB,False,1,e5416a97-a8ea-415f-928a-e75a5090cd46.jpg,Airplane,616,818,456,648,202,192
1566,2560,2560,JPEG,RGB,False,1,e5416a97-a8ea-415f-928a-e75a5090cd46.jpg,Airplane,832,1024,372,582,192,210
1567,2560,2560,JPEG,RGB,False,1,e5416a97-a8ea-415f-928a-e75a5090cd46.jpg,Airplane,1055,1237,297,504,182,207
1568,2560,2560,JPEG,RGB,False,1,e5416a97-a8ea-415f-928a-e75a5090cd46.jpg,Airplane,1277,1425,223,413,148,190
1569,2560,2560,JPEG,RGB,False,1,e5416a97-a8ea-415f-928a-e75a5090cd46.jpg,Airplane,1478,1653,135,345,175,210
1570,2560,2560,JPEG,RGB,False,1,e5416a97-a8ea-415f-928a-e75a5090cd46.jpg,Airplane,1676,1833,85,258,157,173
1571,2560,2560,JPEG,RGB,False,1,e5416a97-a8ea-415f-928a-e75a5090cd46.jpg,Airplane,1854,2009,9,194,155,185
1572,2560,2560,JPEG,RGB,False,1,e5416a97-a8ea-415f-928a-e75a5090cd46.jpg,Airplane,1348,1458,722,854,110,132
1573,2560,2560,JPEG,RGB,False,1,e5416a97-a8ea-415f-928a-e75a5090cd46.jpg,Airplane,1184,1298,978,1070,114,92
1574,2560,2560,JPEG,RGB,False,1,e5416a97-a8ea-415f-928a-e75a5090cd46.jpg,Airplane,319,508,1411,1592,189,181
1575,2560,2560,JPEG,RGB,False,1,e5416a97-a8ea-415f-928a-e75a5090cd46.jpg,Truncated_airplane,1,94,1599,1747,93,148
1576,2560,2560,JPEG,RGB,False,1,e5416a97-a8ea-415f-928a-e75a5090cd46.jpg,Airplane,64,158,2146,2250,94,104
1577,2560,2560,JPEG,RGB,False,1,e5416a97-a8ea-415f-928a-e75a5090cd46.jpg,Airplane,198,276,2136,2237,78,101
1578,2560,2560,JPEG,RGB,False,1,e5416a97-a8ea-415f-928a-e75a5090cd46.jpg,Airplane,459,543,2015,2122,84,107
1579,2560,2560,JPEG,RGB,False,1,e5416a97-a8ea-415f-928a-e75a5090cd46.jpg,Airplane,570,673,1983,2076,103,93
1580,2560,2560,JPEG,RGB,False,1,e5416a97-a8ea-415f-928a-e75a5090cd46.jpg,Airplane,468,587,2299,2401,119,102
1581,2560,2560,JPEG,RGB,False,1,e5416a97-a8ea-415f-928a-e75a5090cd46.jpg,Airplane,1099,1181,1207,1317,82,110
1582,2560,2560,JPEG,RGB,False,1,e5416a97-a8ea-415f-928a-e75a5090cd46.jpg,Airplane,1193,1289,1158,1277,96,119
1583,2560,2560,JPEG,RGB,False,1,e5416a97-a8ea-415f-928a-e75a5090cd46.jpg,Airplane,1297,1391,1144,1252,94,108
1584,2560,2560,JPEG,RGB,False,1,e5416a97-a8ea-415f-928a-e75a5090cd46.jpg,Airplane,1615,1705,730,869,90,139
1585,2560,2560,JPEG,RGB,False,1,e5416a97-a8ea-415f-928a-e75a5090cd46.jpg,Airplane,1566,1663,1000,1136,97,136
1586,2560,2560,JPEG,RGB,False,1,e5416a97-a8ea-415f-928a-e75a5090cd46.jpg,Airplane,1679,1780,980,1090,101,110
1587,2560,2560,JPEG,RGB,False,1,e5416a97-a8ea-415f-928a-e75a5090cd46.jpg,Airplane,1841,1974,808,912,133,104
1588,2560,2560,JPEG,RGB,False,1,e5416a97-a8ea-415f-928a-e75a5090cd46.jpg,Airplane,1865,2054,628,806,189,178
1589,2560,2560,JPEG,RGB,False,1,e5416a97-a8ea-415f-928a-e75a5090cd46.jpg,Airplane,1952,2122,459,623,170,164
1590,2560,2560,JPEG,RGB,False,1,e5416a97-a8ea-415f-928a-e75a5090cd46.jpg,Airplane,2060,2190,360,461,130,101
1591,2560,2560,JPEG,RGB,False,1,e5416a97-a8ea-415f-928a-e75a5090cd46.jpg,Airplane,2135,2265,213,314,130,101
1592,2560,2560,JPEG,RGB,False,1,e5416a97-a8ea-415f-928a-e75a5090cd46.jpg,Airplane,2323,2516,297,462,193,165
1593,2560,2560,JPEG,RGB,False,1,e5416a97-a8ea-415f-928a-e75a5090cd46.jpg,Airplane,2304,2429,472,568,125,96
1594,2560,2560,JPEG,RGB,False,1,e5416a97-a8ea-415f-928a-e75a5090cd46.jpg,Airplane,2195,2424,589,763,229,174
1595,2560,2560,JPEG,RGB,False,1,e5416a97-a8ea-415f-928a-e75a5090cd46.jpg,Airplane,2126,2326,758,929,200,171
1596,2560,2560,JPEG,RGB,False,1,e5416a97-a8ea-415f-928a-e75a5090cd46.jpg,Truncated_airplane,2478,2557,27,176,79,149
1597,2560,2560,JPEG,RGB,False,1,e5416a97-a8ea-415f-928a-e75a5090cd46.jpg,Airplane,1403,1495,1079,1205,92,126
1598,2560,2560,JPEG,RGB,False,1,f34f05c6-84ce-47d7-ba5c-394d85c86a46.jpg,Airplane,1505,1587,233,331,82,98
1599,2560,2560,JPEG,RGB,False,1,f34f05c6-84ce-47d7-ba5c-394d85c86a46.jpg,Airplane,960,1064,9,121,104,112
1600,2560,2560,JPEG,RGB,False,1,f34f05c6-84ce-47d7-ba5c-394d85c86a46.jpg,Airplane,826,951,300,402,125,102
1601,2560,2560,JPEG,RGB,False,1,f34f05c6-84ce-47d7-ba5c-394d85c86a46.jpg,Airplane,633,757,1176,1283,124,107
1602,2560,2560,JPEG,RGB,False,1,f34f05c6-84ce-47d7-ba5c-394d85c86a46.jpg,Airplane,585,706,1294,1399,121,105
1603,2560,2560,JPEG,RGB,False,1,f34f05c6-84ce-47d7-ba5c-394d85c86a46.jpg,Airplane,311,451,1753,1883,140,130
1604,2560,2560,JPEG,RGB,False,1,f34f05c6-84ce-47d7-ba5c-394d85c86a46.jpg,Airplane,163,240,1940,2005,77,65
1605,2560,2560,JPEG,RGB,False,1,f34f05c6-84ce-47d7-ba5c-394d85c86a46.jpg,Airplane,204,300,2115,2219,96,104
1606,2560,2560,JPEG,RGB,False,1,f34f05c6-84ce-47d7-ba5c-394d85c86a46.jpg,Truncated_airplane,0,92,2340,2467,92,127
1607,2560,2560,JPEG,RGB,False,1,f34f05c6-84ce-47d7-ba5c-394d85c86a46.jpg,Airplane,1358,1417,1213,1271,59,58
1608,2560,2560,JPEG,RGB,False,1,f34f05c6-84ce-47d7-ba5c-394d85c86a46.jpg,Airplane,1881,1998,1362,1467,117,105
1609,2560,2560,JPEG,RGB,False,1,f34f05c6-84ce-47d7-ba5c-394d85c86a46.jpg,Airplane,2351,2413,1279,1350,62,71
1610,2560,2560,JPEG,RGB,False,1,f34f05c6-84ce-47d7-ba5c-394d85c86a46.jpg,Airplane,2293,2354,1422,1491,61,69
1611,2560,2560,JPEG,RGB,False,1,f34f05c6-84ce-47d7-ba5c-394d85c86a46.jpg,Airplane,2241,2290,1571,1622,49,51
1612,2560,2560,JPEG,RGB,False,1,f34f05c6-84ce-47d7-ba5c-394d85c86a46.jpg,Airplane,2177,2237,1700,1769,60,69
1613,2560,2560,JPEG,RGB,False,1,f34f05c6-84ce-47d7-ba5c-394d85c86a46.jpg,Airplane,1675,1735,2094,2162,60,68
1614,2560,2560,JPEG,RGB,False,1,f34f05c6-84ce-47d7-ba5c-394d85c86a46.jpg,Airplane,1390,1504,1772,1867,114,95
1615,2560,2560,JPEG,RGB,False,1,f34f05c6-84ce-47d7-ba5c-394d85c86a46.jpg,Airplane,1341,1443,1897,1991,102,94
1616,2560,2560,JPEG,RGB,False,1,f34f05c6-84ce-47d7-ba5c-394d85c86a46.jpg,Airplane,1438,1562,1660,1760,124,100
1617,2560,2560,JPEG,RGB,False,1,f34f05c6-84ce-47d7-ba5c-394d85c86a46.jpg,Airplane,1540,1653,1426,1522,113,96
1618,2560,2560,JPEG,RGB,False,1,f34f05c6-84ce-47d7-ba5c-394d85c86a46.jpg,Airplane,1967,2034,1920,1992,67,72
1619,2560,2560,JPEG,RGB,False,1,f34f05c6-84ce-47d7-ba5c-394d85c86a46.jpg,Airplane,2227,2287,2446,2518,60,72
1620,2560,2560,JPEG,RGB,False,1,f34f05c6-84ce-47d7-ba5c-394d85c86a46.jpg,Truncated_airplane,1541,1626,2500,2560,85,60
1621,2560,2560,JPEG,RGB,False,1,f34f05c6-84ce-47d7-ba5c-394d85c86a46.jpg,Airplane,2132,2192,531,599,60,68
1622,2560,2560,JPEG,RGB,False,1,f34f05c6-84ce-47d7-ba5c-394d85c86a46.jpg,Truncated_airplane,0,23,1585,1639,23,54
1623,2560,2560,JPEG,RGB,False,1,78099b50-f2b6-4319-b462-f33df2966c45.jpg,Airplane,716,810,351,444,94,93
1624,2560,2560,JPEG,RGB,False,1,78099b50-f2b6-4319-b462-f33df2966c45.jpg,Airplane,945,1075,325,477,130,152
1625,2560,2560,JPEG,RGB,False,1,78099b50-f2b6-4319-b462-f33df2966c45.jpg,Airplane,1291,1411,376,473,120,97
1626,2560,2560,JPEG,RGB,False,1,78099b50-f2b6-4319-b462-f33df2966c45.jpg,Airplane,1908,2075,394,568,167,174
1627,2560,2560,JPEG,RGB,False,1,78099b50-f2b6-4319-b462-f33df2966c45.jpg,Airplane,2301,2481,338,517,180,179
1628,2560,2560,JPEG,RGB,False,1,78099b50-f2b6-4319-b462-f33df2966c45.jpg,Airplane,1874,2069,593,768,195,175
1629,2560,2560,JPEG,RGB,False,1,78099b50-f2b6-4319-b462-f33df2966c45.jpg,Airplane,1283,1378,628,723,95,95
1630,2560,2560,JPEG,RGB,False,1,78099b50-f2b6-4319-b462-f33df2966c45.jpg,Airplane,1362,1456,762,854,94,92
1631,2560,2560,JPEG,RGB,False,1,78099b50-f2b6-4319-b462-f33df2966c45.jpg,Airplane,1287,1387,878,974,100,96
1632,2560,2560,JPEG,RGB,False,1,78099b50-f2b6-4319-b462-f33df2966c45.jpg,Airplane,1282,1382,1017,1107,100,90
1633,2560,2560,JPEG,RGB,False,1,78099b50-f2b6-4319-b462-f33df2966c45.jpg,Airplane,1230,1377,1156,1283,147,127
1634,2560,2560,JPEG,RGB,False,1,78099b50-f2b6-4319-b462-f33df2966c45.jpg,Airplane,1285,1387,1314,1405,102,91
1635,2560,2560,JPEG,RGB,False,1,78099b50-f2b6-4319-b462-f33df2966c45.jpg,Airplane,1898,2052,796,963,154,167
1636,2560,2560,JPEG,RGB,False,1,78099b50-f2b6-4319-b462-f33df2966c45.jpg,Airplane,2301,2471,900,1064,170,164
1637,2560,2560,JPEG,RGB,False,1,78099b50-f2b6-4319-b462-f33df2966c45.jpg,Airplane,1955,2049,1023,1118,94,95
1638,2560,2560,JPEG,RGB,False,1,78099b50-f2b6-4319-b462-f33df2966c45.jpg,Airplane,1880,2072,1186,1362,192,176
1639,2560,2560,JPEG,RGB,False,1,78099b50-f2b6-4319-b462-f33df2966c45.jpg,Airplane,2292,2486,1132,1317,194,185
1640,2560,2560,JPEG,RGB,False,1,78099b50-f2b6-4319-b462-f33df2966c45.jpg,Airplane,1886,2065,1395,1558,179,163
1641,2560,2560,JPEG,RGB,False,1,78099b50-f2b6-4319-b462-f33df2966c45.jpg,Airplane,2289,2446,1381,1546,157,165
1642,2560,2560,JPEG,RGB,False,1,78099b50-f2b6-4319-b462-f33df2966c45.jpg,Airplane,1687,1826,1506,1661,139,155
1643,2560,2560,JPEG,RGB,False,1,78099b50-f2b6-4319-b462-f33df2966c45.jpg,Airplane,1499,1593,1639,1743,94,104
1644,2560,2560,JPEG,RGB,False,1,78099b50-f2b6-4319-b462-f33df2966c45.jpg,Airplane,1300,1385,1434,1521,85,87
1645,2560,2560,JPEG,RGB,False,1,78099b50-f2b6-4319-b462-f33df2966c45.jpg,Airplane,1238,1394,1575,1707,156,132
1646,2560,2560,JPEG,RGB,False,1,78099b50-f2b6-4319-b462-f33df2966c45.jpg,Airplane,1171,1258,1792,1894,87,102
1647,2560,2560,JPEG,RGB,False,1,78099b50-f2b6-4319-b462-f33df2966c45.jpg,Airplane,1044,1133,1788,1883,89,95
1648,2560,2560,JPEG,RGB,False,1,78099b50-f2b6-4319-b462-f33df2966c45.jpg,Airplane,907,1000,1797,1892,93,95
1649,2560,2560,JPEG,RGB,False,1,78099b50-f2b6-4319-b462-f33df2966c45.jpg,Airplane,768,866,1798,1898,98,100
1650,2560,2560,JPEG,RGB,False,1,78099b50-f2b6-4319-b462-f33df2966c45.jpg,Airplane,2308,2476,1602,1762,168,160
1651,2560,2560,JPEG,RGB,False,1,78099b50-f2b6-4319-b462-f33df2966c45.jpg,Airplane,2305,2492,1792,1970,187,178
1652,2560,2560,JPEG,RGB,False,1,78099b50-f2b6-4319-b462-f33df2966c45.jpg,Airplane,1893,2073,1789,1955,180,166
1653,2560,2560,JPEG,RGB,False,1,78099b50-f2b6-4319-b462-f33df2966c45.jpg,Airplane,1908,2094,1990,2162,186,172
1654,2560,2560,JPEG,RGB,False,1,78099b50-f2b6-4319-b462-f33df2966c45.jpg,Airplane,1259,1349,1940,2033,90,93
1655,2560,2560,JPEG,RGB,False,1,78099b50-f2b6-4319-b462-f33df2966c45.jpg,Airplane,1217,1310,2068,2164,93,96
1656,2560,2560,JPEG,RGB,False,1,78099b50-f2b6-4319-b462-f33df2966c45.jpg,Airplane,847,941,2072,2184,94,112
1657,2560,2560,JPEG,RGB,False,1,78099b50-f2b6-4319-b462-f33df2966c45.jpg,Airplane,999,1161,2313,2486,162,173
1658,2560,2560,JPEG,RGB,False,1,4e8c95f3-bbb6-4e2f-920d-8d3b2bd1d29f.jpg,Airplane,1821,1921,97,186,100,89
1659,2560,2560,JPEG,RGB,False,1,4e8c95f3-bbb6-4e2f-920d-8d3b2bd1d29f.jpg,Airplane,2017,2097,197,282,80,85
1660,2560,2560,JPEG,RGB,False,1,4e8c95f3-bbb6-4e2f-920d-8d3b2bd1d29f.jpg,Airplane,1709,1809,318,441,100,123
1661,2560,2560,JPEG,RGB,False,1,4e8c95f3-bbb6-4e2f-920d-8d3b2bd1d29f.jpg,Airplane,1827,1907,388,481,80,93
1662,2560,2560,JPEG,RGB,False,1,4e8c95f3-bbb6-4e2f-920d-8d3b2bd1d29f.jpg,Airplane,1924,1979,445,527,55,82
1663,2560,2560,JPEG,RGB,False,1,4e8c95f3-bbb6-4e2f-920d-8d3b2bd1d29f.jpg,Airplane,1832,1923,705,776,91,71
1664,2560,2560,JPEG,RGB,False,1,4e8c95f3-bbb6-4e2f-920d-8d3b2bd1d29f.jpg,Airplane,1756,1826,648,746,70,98
1665,2560,2560,JPEG,RGB,False,1,4e8c95f3-bbb6-4e2f-920d-8d3b2bd1d29f.jpg,Airplane,1593,1759,1322,1449,166,127
1666,2560,2560,JPEG,RGB,False,1,4e8c95f3-bbb6-4e2f-920d-8d3b2bd1d29f.jpg,Airplane,2038,2097,1112,1190,59,78
1667,2560,2560,JPEG,RGB,False,1,5bb8ab95-f141-43ca-a722-a1937d9d5a72.jpg,Airplane,1114,1224,653,737,110,84
1668,2560,2560,JPEG,RGB,False,1,5bb8ab95-f141-43ca-a722-a1937d9d5a72.jpg,Airplane,1106,1199,763,845,93,82
1669,2560,2560,JPEG,RGB,False,1,5bb8ab95-f141-43ca-a722-a1937d9d5a72.jpg,Airplane,1053,1143,979,1064,90,85
1670,2560,2560,JPEG,RGB,False,1,5bb8ab95-f141-43ca-a722-a1937d9d5a72.jpg,Airplane,628,741,1256,1346,113,90
1671,2560,2560,JPEG,RGB,False,1,5bb8ab95-f141-43ca-a722-a1937d9d5a72.jpg,Airplane,881,1000,1730,1835,119,105
1672,2560,2560,JPEG,RGB,False,1,5bb8ab95-f141-43ca-a722-a1937d9d5a72.jpg,Airplane,492,592,1823,1914,100,91
1673,2560,2560,JPEG,RGB,False,1,ef8ff443-e09b-405d-a432-3b5bde0a278b.jpg,Airplane,397,491,1694,1813,94,119
1674,2560,2560,JPEG,RGB,False,1,ef8ff443-e09b-405d-a432-3b5bde0a278b.jpg,Airplane,505,590,1664,1773,85,109
1675,2560,2560,JPEG,RGB,False,1,ef8ff443-e09b-405d-a432-3b5bde0a278b.jpg,Airplane,610,680,1616,1709,70,93
1676,2560,2560,JPEG,RGB,False,1,ef8ff443-e09b-405d-a432-3b5bde0a278b.jpg,Airplane,310,397,1407,1500,87,93
1677,2560,2560,JPEG,RGB,False,1,ef8ff443-e09b-405d-a432-3b5bde0a278b.jpg,Airplane,2066,2137,12,76,71,64
1678,2560,2560,JPEG,RGB,False,1,ef8ff443-e09b-405d-a432-3b5bde0a278b.jpg,Airplane,1963,2072,199,304,109,105
1679,2560,2560,JPEG,RGB,False,1,ef8ff443-e09b-405d-a432-3b5bde0a278b.jpg,Airplane,2423,2489,378,445,66,67
1680,2560,2560,JPEG,RGB,False,1,ef8ff443-e09b-405d-a432-3b5bde0a278b.jpg,Airplane,1978,2033,477,559,55,82
1681,2560,2560,JPEG,RGB,False,1,ef8ff443-e09b-405d-a432-3b5bde0a278b.jpg,Airplane,1885,1950,441,526,65,85
1682,2560,2560,JPEG,RGB,False,1,ef8ff443-e09b-405d-a432-3b5bde0a278b.jpg,Airplane,744,819,821,877,75,56
1683,2560,2560,JPEG,RGB,False,1,ef8ff443-e09b-405d-a432-3b5bde0a278b.jpg,Airplane,1435,1563,2291,2397,128,106
1684,2560,2560,JPEG,RGB,False,1,ef8ff443-e09b-405d-a432-3b5bde0a278b.jpg,Airplane,1155,1279,2091,2195,124,104
1685,2560,2560,JPEG,RGB,False,1,ef8ff443-e09b-405d-a432-3b5bde0a278b.jpg,Airplane,237,326,1618,1680,89,62
1686,2560,2560,JPEG,RGB,False,1,ef8ff443-e09b-405d-a432-3b5bde0a278b.jpg,Airplane,593,716,1025,1133,123,108
1687,2560,2560,JPEG,RGB,False,1,ef8ff443-e09b-405d-a432-3b5bde0a278b.jpg,Airplane,457,524,1073,1147,67,74
1688,2560,2560,JPEG,RGB,False,1,ef8ff443-e09b-405d-a432-3b5bde0a278b.jpg,Airplane,500,624,1252,1351,124,99
1689,2560,2560,JPEG,RGB,False,1,ef8ff443-e09b-405d-a432-3b5bde0a278b.jpg,Airplane,411,507,1338,1445,96,107
1690,2560,2560,JPEG,RGB,False,1,ef8ff443-e09b-405d-a432-3b5bde0a278b.jpg,Airplane,1778,1835,701,753,57,52
1691,2560,2560,JPEG,RGB,False,1,ef8ff443-e09b-405d-a432-3b5bde0a278b.jpg,Airplane,2094,2166,1137,1202,72,65
1692,2560,2560,JPEG,RGB,False,1,ef8ff443-e09b-405d-a432-3b5bde0a278b.jpg,Airplane,2100,2169,1250,1304,69,54
1693,2560,2560,JPEG,RGB,False,1,ef8ff443-e09b-405d-a432-3b5bde0a278b.jpg,Airplane,1857,1930,1175,1242,73,67
1694,2560,2560,JPEG,RGB,False,1,ef8ff443-e09b-405d-a432-3b5bde0a278b.jpg,Airplane,1729,1800,1658,1725,71,67
1695,2560,2560,JPEG,RGB,False,1,ef8ff443-e09b-405d-a432-3b5bde0a278b.jpg,Airplane,1560,1678,1142,1243,118,101
1696,2560,2560,JPEG,RGB,False,1,ef8ff443-e09b-405d-a432-3b5bde0a278b.jpg,Airplane,1427,1490,1472,1530,63,58
1697,2560,2560,JPEG,RGB,False,1,074737f4-7f59-4729-be5d-67f6f1d34668.jpg,Airplane,534,634,5,76,100,71
1698,2560,2560,JPEG,RGB,False,1,074737f4-7f59-4729-be5d-67f6f1d34668.jpg,Airplane,701,796,89,202,95,113
1699,2560,2560,JPEG,RGB,False,1,074737f4-7f59-4729-be5d-67f6f1d34668.jpg,Airplane,516,614,102,187,98,85
1700,2560,2560,JPEG,RGB,False,1,074737f4-7f59-4729-be5d-67f6f1d34668.jpg,Airplane,1019,1126,270,377,107,107
1701,2560,2560,JPEG,RGB,False,1,074737f4-7f59-4729-be5d-67f6f1d34668.jpg,Airplane,183,287,440,508,104,68
1702,2560,2560,JPEG,RGB,False,1,074737f4-7f59-4729-be5d-67f6f1d34668.jpg,Airplane,143,243,517,590,100,73
1703,2560,2560,JPEG,RGB,False,1,074737f4-7f59-4729-be5d-67f6f1d34668.jpg,Airplane,551,648,670,780,97,110
1704,2560,2560,JPEG,RGB,False,1,074737f4-7f59-4729-be5d-67f6f1d34668.jpg,Airplane,372,477,798,866,105,68
1705,2560,2560,JPEG,RGB,False,1,074737f4-7f59-4729-be5d-67f6f1d34668.jpg,Airplane,393,484,910,982,91,72
1706,2560,2560,JPEG,RGB,False,1,074737f4-7f59-4729-be5d-67f6f1d34668.jpg,Airplane,490,561,949,1045,71,96
1707,2560,2560,JPEG,RGB,False,1,074737f4-7f59-4729-be5d-67f6f1d34668.jpg,Airplane,694,763,862,952,69,90
1708,2560,2560,JPEG,RGB,False,1,074737f4-7f59-4729-be5d-67f6f1d34668.jpg,Airplane,810,876,876,977,66,101
1709,2560,2560,JPEG,RGB,False,1,074737f4-7f59-4729-be5d-67f6f1d34668.jpg,Airplane,880,986,1111,1184,106,73
1710,2560,2560,JPEG,RGB,False,1,074737f4-7f59-4729-be5d-67f6f1d34668.jpg,Airplane,903,999,1211,1282,96,71
1711,2560,2560,JPEG,RGB,False,1,074737f4-7f59-4729-be5d-67f6f1d34668.jpg,Airplane,733,809,1267,1347,76,80
1712,2560,2560,JPEG,RGB,False,1,074737f4-7f59-4729-be5d-67f6f1d34668.jpg,Airplane,650,722,1293,1371,72,78
1713,2560,2560,JPEG,RGB,False,1,074737f4-7f59-4729-be5d-67f6f1d34668.jpg,Airplane,638,725,1379,1461,87,82
1714,2560,2560,JPEG,RGB,False,1,074737f4-7f59-4729-be5d-67f6f1d34668.jpg,Airplane,665,751,1468,1537,86,69
1715,2560,2560,JPEG,RGB,False,1,074737f4-7f59-4729-be5d-67f6f1d34668.jpg,Airplane,1213,1292,1323,1396,79,73
1716,2560,2560,JPEG,RGB,False,1,074737f4-7f59-4729-be5d-67f6f1d34668.jpg,Airplane,1486,1561,1361,1438,75,77
1717,2560,2560,JPEG,RGB,False,1,074737f4-7f59-4729-be5d-67f6f1d34668.jpg,Airplane,1629,1704,1585,1660,75,75
1718,2560,2560,JPEG,RGB,False,1,074737f4-7f59-4729-be5d-67f6f1d34668.jpg,Airplane,1751,1826,1816,1892,75,76
1719,2560,2560,JPEG,RGB,False,1,074737f4-7f59-4729-be5d-67f6f1d34668.jpg,Airplane,1825,1901,1998,2070,76,72
1720,2560,2560,JPEG,RGB,False,1,074737f4-7f59-4729-be5d-67f6f1d34668.jpg,Airplane,2027,2106,2128,2206,79,78
1721,2560,2560,JPEG,RGB,False,1,074737f4-7f59-4729-be5d-67f6f1d34668.jpg,Airplane,2143,2226,2026,2105,83,79
1722,2560,2560,JPEG,RGB,False,1,074737f4-7f59-4729-be5d-67f6f1d34668.jpg,Airplane,2017,2094,1684,1757,77,73
1723,2560,2560,JPEG,RGB,False,1,074737f4-7f59-4729-be5d-67f6f1d34668.jpg,Airplane,2167,2240,1625,1711,73,86
1724,2560,2560,JPEG,RGB,False,1,074737f4-7f59-4729-be5d-67f6f1d34668.jpg,Airplane,2058,2134,1756,1830,76,74
1725,2560,2560,JPEG,RGB,False,1,074737f4-7f59-4729-be5d-67f6f1d34668.jpg,Airplane,2091,2168,1835,1915,77,80
1726,2560,2560,JPEG,RGB,False,1,074737f4-7f59-4729-be5d-67f6f1d34668.jpg,Airplane,1876,1968,2388,2472,92,84
1727,2560,2560,JPEG,RGB,False,1,b6e9f8fc-3fbd-411a-a1e5-b853e8fbe2ac.jpg,Airplane,67,151,146,224,84,78
1728,2560,2560,JPEG,RGB,False,1,b6e9f8fc-3fbd-411a-a1e5-b853e8fbe2ac.jpg,Airplane,509,618,413,526,109,113
1729,2560,2560,JPEG,RGB,False,1,b6e9f8fc-3fbd-411a-a1e5-b853e8fbe2ac.jpg,Airplane,630,708,502,575,78,73
1730,2560,2560,JPEG,RGB,False,1,b6e9f8fc-3fbd-411a-a1e5-b853e8fbe2ac.jpg,Airplane,732,787,526,597,55,71
1731,2560,2560,JPEG,RGB,False,1,b6e9f8fc-3fbd-411a-a1e5-b853e8fbe2ac.jpg,Airplane,788,835,550,596,47,46
1732,2560,2560,JPEG,RGB,False,1,b6e9f8fc-3fbd-411a-a1e5-b853e8fbe2ac.jpg,Airplane,826,878,594,648,52,54
1733,2560,2560,JPEG,RGB,False,1,b6e9f8fc-3fbd-411a-a1e5-b853e8fbe2ac.jpg,Airplane,837,871,650,689,34,39
1734,2560,2560,JPEG,RGB,False,1,b6e9f8fc-3fbd-411a-a1e5-b853e8fbe2ac.jpg,Airplane,787,839,657,714,52,57
1735,2560,2560,JPEG,RGB,False,1,b6e9f8fc-3fbd-411a-a1e5-b853e8fbe2ac.jpg,Airplane,901,954,624,683,53,59
1736,2560,2560,JPEG,RGB,False,1,b6e9f8fc-3fbd-411a-a1e5-b853e8fbe2ac.jpg,Airplane,962,1015,667,726,53,59
1737,2560,2560,JPEG,RGB,False,1,b6e9f8fc-3fbd-411a-a1e5-b853e8fbe2ac.jpg,Airplane,932,984,727,783,52,56
1738,2560,2560,JPEG,RGB,False,1,b6e9f8fc-3fbd-411a-a1e5-b853e8fbe2ac.jpg,Airplane,1031,1077,704,754,46,50
1739,2560,2560,JPEG,RGB,False,1,b6e9f8fc-3fbd-411a-a1e5-b853e8fbe2ac.jpg,Airplane,1072,1115,717,751,43,34
1740,2560,2560,JPEG,RGB,False,1,b6e9f8fc-3fbd-411a-a1e5-b853e8fbe2ac.jpg,Airplane,1014,1055,752,800,41,48
1741,2560,2560,JPEG,RGB,False,1,b6e9f8fc-3fbd-411a-a1e5-b853e8fbe2ac.jpg,Airplane,1081,1133,738,788,52,50
1742,2560,2560,JPEG,RGB,False,1,b6e9f8fc-3fbd-411a-a1e5-b853e8fbe2ac.jpg,Airplane,1067,1104,786,824,37,38
1743,2560,2560,JPEG,RGB,False,1,b6e9f8fc-3fbd-411a-a1e5-b853e8fbe2ac.jpg,Airplane,1229,1277,832,881,48,49
1744,2560,2560,JPEG,RGB,False,1,b6e9f8fc-3fbd-411a-a1e5-b853e8fbe2ac.jpg,Airplane,1215,1249,884,927,34,43
1745,2560,2560,JPEG,RGB,False,1,b6e9f8fc-3fbd-411a-a1e5-b853e8fbe2ac.jpg,Airplane,1271,1319,851,902,48,51
1746,2560,2560,JPEG,RGB,False,1,b6e9f8fc-3fbd-411a-a1e5-b853e8fbe2ac.jpg,Airplane,1315,1365,878,934,50,56
1747,2560,2560,JPEG,RGB,False,1,b6e9f8fc-3fbd-411a-a1e5-b853e8fbe2ac.jpg,Airplane,1279,1325,949,999,46,50
1748,2560,2560,JPEG,RGB,False,1,b6e9f8fc-3fbd-411a-a1e5-b853e8fbe2ac.jpg,Airplane,1620,1694,1107,1176,74,69
1749,2560,2560,JPEG,RGB,False,1,b6e9f8fc-3fbd-411a-a1e5-b853e8fbe2ac.jpg,Airplane,1774,1849,822,885,75,63
1750,2560,2560,JPEG,RGB,False,1,b6e9f8fc-3fbd-411a-a1e5-b853e8fbe2ac.jpg,Airplane,1853,1934,677,740,81,63
1751,2560,2560,JPEG,RGB,False,1,b6e9f8fc-3fbd-411a-a1e5-b853e8fbe2ac.jpg,Truncated_airplane,1,30,76,139,29,63
1752,2560,2560,JPEG,RGB,False,1,b6e9f8fc-3fbd-411a-a1e5-b853e8fbe2ac.jpg,Truncated_airplane,2493,2561,713,826,68,113
1753,2560,2560,JPEG,RGB,False,1,b6e9f8fc-3fbd-411a-a1e5-b853e8fbe2ac.jpg,Airplane,2422,2535,838,944,113,106
1754,2560,2560,JPEG,RGB,False,1,b6e9f8fc-3fbd-411a-a1e5-b853e8fbe2ac.jpg,Airplane,2335,2444,988,1094,109,106
1755,2560,2560,JPEG,RGB,False,1,b6e9f8fc-3fbd-411a-a1e5-b853e8fbe2ac.jpg,Airplane,1876,2022,1270,1400,146,130
1756,2560,2560,JPEG,RGB,False,1,d3d2b706-9017-41f4-b57e-469038daa634.jpg,Airplane,1249,1324,125,202,75,77
1757,2560,2560,JPEG,RGB,False,1,d3d2b706-9017-41f4-b57e-469038daa634.jpg,Truncated_airplane,1853,1897,0,31,44,31
1758,2560,2560,JPEG,RGB,False,1,d3d2b706-9017-41f4-b57e-469038daa634.jpg,Airplane,1868,1943,406,495,75,89
1759,2560,2560,JPEG,RGB,False,1,d3d2b706-9017-41f4-b57e-469038daa634.jpg,Airplane,1681,1766,405,503,85,98
1760,2560,2560,JPEG,RGB,False,1,d3d2b706-9017-41f4-b57e-469038daa634.jpg,Airplane,1375,1452,412,499,77,87
1761,2560,2560,JPEG,RGB,False,1,d3d2b706-9017-41f4-b57e-469038daa634.jpg,Airplane,1284,1366,399,493,82,94
1762,2560,2560,JPEG,RGB,False,1,d3d2b706-9017-41f4-b57e-469038daa634.jpg,Airplane,1094,1185,402,500,91,98
1763,2560,2560,JPEG,RGB,False,1,d3d2b706-9017-41f4-b57e-469038daa634.jpg,Airplane,983,1061,402,495,78,93
1764,2560,2560,JPEG,RGB,False,1,d3d2b706-9017-41f4-b57e-469038daa634.jpg,Airplane,893,972,403,500,79,97
1765,2560,2560,JPEG,RGB,False,1,d3d2b706-9017-41f4-b57e-469038daa634.jpg,Airplane,798,875,403,498,77,95
1766,2560,2560,JPEG,RGB,False,1,d3d2b706-9017-41f4-b57e-469038daa634.jpg,Airplane,1788,1870,673,756,82,83
1767,2560,2560,JPEG,RGB,False,1,d3d2b706-9017-41f4-b57e-469038daa634.jpg,Airplane,1592,1673,704,795,81,91
1768,2560,2560,JPEG,RGB,False,1,d3d2b706-9017-41f4-b57e-469038daa634.jpg,Airplane,1273,1358,662,752,85,90
1769,2560,2560,JPEG,RGB,False,1,d3d2b706-9017-41f4-b57e-469038daa634.jpg,Airplane,1188,1269,668,760,81,92
1770,2560,2560,JPEG,RGB,False,1,d3d2b706-9017-41f4-b57e-469038daa634.jpg,Airplane,989,1068,670,753,79,83
1771,2560,2560,JPEG,RGB,False,1,d3d2b706-9017-41f4-b57e-469038daa634.jpg,Airplane,888,969,669,762,81,93
1772,2560,2560,JPEG,RGB,False,1,d3d2b706-9017-41f4-b57e-469038daa634.jpg,Airplane,791,882,663,751,91,88
1773,2560,2560,JPEG,RGB,False,1,d3d2b706-9017-41f4-b57e-469038daa634.jpg,Airplane,2493,2539,1436,1503,46,67
1774,2560,2560,JPEG,RGB,False,1,d3d2b706-9017-41f4-b57e-469038daa634.jpg,Airplane,2335,2418,1423,1529,83,106
1775,2560,2560,JPEG,RGB,False,1,d3d2b706-9017-41f4-b57e-469038daa634.jpg,Airplane,2248,2329,1424,1529,81,105
1776,2560,2560,JPEG,RGB,False,1,d3d2b706-9017-41f4-b57e-469038daa634.jpg,Airplane,2113,2190,1426,1519,77,93
1777,2560,2560,JPEG,RGB,False,1,d3d2b706-9017-41f4-b57e-469038daa634.jpg,Airplane,2016,2096,1430,1523,80,93
1778,2560,2560,JPEG,RGB,False,1,d3d2b706-9017-41f4-b57e-469038daa634.jpg,Airplane,1918,2000,1427,1525,82,98
1779,2560,2560,JPEG,RGB,False,1,d3d2b706-9017-41f4-b57e-469038daa634.jpg,Airplane,1804,1884,1413,1523,80,110
1780,2560,2560,JPEG,RGB,False,1,d3d2b706-9017-41f4-b57e-469038daa634.jpg,Airplane,1705,1790,1419,1523,85,104
1781,2560,2560,JPEG,RGB,False,1,d3d2b706-9017-41f4-b57e-469038daa634.jpg,Airplane,1614,1694,1407,1528,80,121
1782,2560,2560,JPEG,RGB,False,1,d3d2b706-9017-41f4-b57e-469038daa634.jpg,Airplane,1330,1411,1416,1510,81,94
1783,2560,2560,JPEG,RGB,False,1,d3d2b706-9017-41f4-b57e-469038daa634.jpg,Airplane,1189,1273,1415,1517,84,102
1784,2560,2560,JPEG,RGB,False,1,d3d2b706-9017-41f4-b57e-469038daa634.jpg,Airplane,935,1020,1086,1168,85,82
1785,2560,2560,JPEG,RGB,False,1,d3d2b706-9017-41f4-b57e-469038daa634.jpg,Airplane,1098,1182,1414,1516,84,102
1786,2560,2560,JPEG,RGB,False,1,d3d2b706-9017-41f4-b57e-469038daa634.jpg,Airplane,983,1064,1412,1515,81,103
1787,2560,2560,JPEG,RGB,False,1,d3d2b706-9017-41f4-b57e-469038daa634.jpg,Airplane,891,974,1418,1517,83,99
1788,2560,2560,JPEG,RGB,False,1,d3d2b706-9017-41f4-b57e-469038daa634.jpg,Airplane,789,882,1410,1518,93,108
1789,2560,2560,JPEG,RGB,False,1,d3d2b706-9017-41f4-b57e-469038daa634.jpg,Airplane,698,783,1405,1511,85,106
1790,2560,2560,JPEG,RGB,False,1,d3d2b706-9017-41f4-b57e-469038daa634.jpg,Airplane,600,690,1415,1519,90,104
1791,2560,2560,JPEG,RGB,False,1,d3d2b706-9017-41f4-b57e-469038daa634.jpg,Airplane,489,568,1413,1510,79,97
1792,2560,2560,JPEG,RGB,False,1,d3d2b706-9017-41f4-b57e-469038daa634.jpg,Airplane,399,481,1414,1508,82,94
1793,2560,2560,JPEG,RGB,False,1,d3d2b706-9017-41f4-b57e-469038daa634.jpg,Airplane,2493,2546,1787,1864,53,77
1794,2560,2560,JPEG,RGB,False,1,d3d2b706-9017-41f4-b57e-469038daa634.jpg,Airplane,2417,2480,1782,1853,63,71
1795,2560,2560,JPEG,RGB,False,1,d3d2b706-9017-41f4-b57e-469038daa634.jpg,Airplane,2343,2406,1784,1857,63,73
1796,2560,2560,JPEG,RGB,False,1,d3d2b706-9017-41f4-b57e-469038daa634.jpg,Airplane,2251,2331,1771,1855,80,84
1797,2560,2560,JPEG,RGB,False,1,d3d2b706-9017-41f4-b57e-469038daa634.jpg,Airplane,2111,2192,1770,1854,81,84
1798,2560,2560,JPEG,RGB,False,1,d3d2b706-9017-41f4-b57e-469038daa634.jpg,Airplane,2015,2097,1774,1861,82,87
1799,2560,2560,JPEG,RGB,False,1,d3d2b706-9017-41f4-b57e-469038daa634.jpg,Airplane,1897,1994,1769,1887,97,118
1800,2560,2560,JPEG,RGB,False,1,d3d2b706-9017-41f4-b57e-469038daa634.jpg,Airplane,1778,1876,1746,1857,98,111
1801,2560,2560,JPEG,RGB,False,1,d3d2b706-9017-41f4-b57e-469038daa634.jpg,Airplane,1606,1748,1732,1880,142,148
1802,2560,2560,JPEG,RGB,False,1,d3d2b706-9017-41f4-b57e-469038daa634.jpg,Airplane,1666,1757,1930,2015,91,85
1803,2560,2560,JPEG,RGB,False,1,d3d2b706-9017-41f4-b57e-469038daa634.jpg,Airplane,1305,1395,1722,1844,90,122
1804,2560,2560,JPEG,RGB,False,1,d3d2b706-9017-41f4-b57e-469038daa634.jpg,Airplane,1126,1264,1728,1866,138,138
1805,2560,2560,JPEG,RGB,False,1,d3d2b706-9017-41f4-b57e-469038daa634.jpg,Airplane,1000,1081,1765,1858,81,93
1806,2560,2560,JPEG,RGB,False,1,d3d2b706-9017-41f4-b57e-469038daa634.jpg,Airplane,905,985,1760,1859,80,99
1807,2560,2560,JPEG,RGB,False,1,d3d2b706-9017-41f4-b57e-469038daa634.jpg,Airplane,804,887,1767,1861,83,94
1808,2560,2560,JPEG,RGB,False,1,d3d2b706-9017-41f4-b57e-469038daa634.jpg,Airplane,677,759,1759,1842,82,83
1809,2560,2560,JPEG,RGB,False,1,d3d2b706-9017-41f4-b57e-469038daa634.jpg,Airplane,578,662,1756,1850,84,94
1810,2560,2560,JPEG,RGB,False,1,d3d2b706-9017-41f4-b57e-469038daa634.jpg,Airplane,484,574,1764,1858,90,94
1811,2560,2560,JPEG,RGB,False,1,d3d2b706-9017-41f4-b57e-469038daa634.jpg,Airplane,399,478,1766,1848,79,82
1812,2560,2560,JPEG,RGB,False,1,791377f0-a01c-4fc3-b6e9-151b6cb80fdf.jpg,Airplane,1773,1872,779,886,99,107
1813,2560,2560,JPEG,RGB,False,1,791377f0-a01c-4fc3-b6e9-151b6cb80fdf.jpg,Airplane,1619,1651,155,196,32,41
1814,2560,2560,JPEG,RGB,False,1,791377f0-a01c-4fc3-b6e9-151b6cb80fdf.jpg,Airplane,1457,1593,234,366,136,132
1815,2560,2560,JPEG,RGB,False,1,791377f0-a01c-4fc3-b6e9-151b6cb80fdf.jpg,Airplane,1319,1453,368,508,134,140
1816,2560,2560,JPEG,RGB,False,1,791377f0-a01c-4fc3-b6e9-151b6cb80fdf.jpg,Airplane,1182,1316,280,418,134,138
1817,2560,2560,JPEG,RGB,False,1,135fdc4c-6656-4176-9873-9f00c6918293.jpg,Airplane,2118,2188,2115,2186,70,71
1818,2560,2560,JPEG,RGB,False,1,135fdc4c-6656-4176-9873-9f00c6918293.jpg,Airplane,2033,2112,2197,2272,79,75
1819,2560,2560,JPEG,RGB,False,1,135fdc4c-6656-4176-9873-9f00c6918293.jpg,Airplane,1937,2005,2170,2242,68,72
1820,2560,2560,JPEG,RGB,False,1,135fdc4c-6656-4176-9873-9f00c6918293.jpg,Airplane,1868,1941,2089,2159,73,70
1821,2560,2560,JPEG,RGB,False,1,135fdc4c-6656-4176-9873-9f00c6918293.jpg,Airplane,2142,2217,1940,2015,75,75
1822,2560,2560,JPEG,RGB,False,1,135fdc4c-6656-4176-9873-9f00c6918293.jpg,Airplane,2098,2169,1843,1918,71,75
1823,2560,2560,JPEG,RGB,False,1,135fdc4c-6656-4176-9873-9f00c6918293.jpg,Airplane,2057,2131,1765,1838,74,73
1824,2560,2560,JPEG,RGB,False,1,135fdc4c-6656-4176-9873-9f00c6918293.jpg,Airplane,2019,2094,1696,1757,75,61
1825,2560,2560,JPEG,RGB,False,1,135fdc4c-6656-4176-9873-9f00c6918293.jpg,Airplane,1975,2046,1614,1687,71,73
1826,2560,2560,JPEG,RGB,False,1,135fdc4c-6656-4176-9873-9f00c6918293.jpg,Airplane,1750,1823,1822,1895,73,73
1827,2560,2560,JPEG,RGB,False,1,135fdc4c-6656-4176-9873-9f00c6918293.jpg,Airplane,1928,2005,1540,1610,77,70
1828,2560,2560,JPEG,RGB,False,1,135fdc4c-6656-4176-9873-9f00c6918293.jpg,Airplane,1026,1128,279,381,102,102
1829,2560,2560,JPEG,RGB,False,1,135fdc4c-6656-4176-9873-9f00c6918293.jpg,Airplane,1274,1345,1394,1473,71,79
1830,2560,2560,JPEG,RGB,False,1,135fdc4c-6656-4176-9873-9f00c6918293.jpg,Airplane,1129,1206,1545,1622,77,77
1831,2560,2560,JPEG,RGB,False,1,135fdc4c-6656-4176-9873-9f00c6918293.jpg,Airplane,1256,1333,1651,1731,77,80
1832,2560,2560,JPEG,RGB,False,1,135fdc4c-6656-4176-9873-9f00c6918293.jpg,Airplane,657,735,1906,1977,78,71
1833,2560,2560,JPEG,RGB,False,1,135fdc4c-6656-4176-9873-9f00c6918293.jpg,Airplane,761,845,1803,1882,84,79
1834,2560,2560,JPEG,RGB,False,1,135fdc4c-6656-4176-9873-9f00c6918293.jpg,Airplane,562,640,1152,1244,78,92
1835,2560,2560,JPEG,RGB,False,1,135fdc4c-6656-4176-9873-9f00c6918293.jpg,Airplane,745,815,1090,1163,70,73
1836,2560,2560,JPEG,RGB,False,1,135fdc4c-6656-4176-9873-9f00c6918293.jpg,Airplane,601,666,940,1023,65,83
1837,2560,2560,JPEG,RGB,False,1,135fdc4c-6656-4176-9873-9f00c6918293.jpg,Airplane,573,637,696,782,64,86
1838,2560,2560,JPEG,RGB,False,1,135fdc4c-6656-4176-9873-9f00c6918293.jpg,Airplane,453,521,719,793,68,74
1839,2560,2560,JPEG,RGB,False,1,135fdc4c-6656-4176-9873-9f00c6918293.jpg,Airplane,616,687,103,204,71,101
1840,2560,2560,JPEG,RGB,False,1,74d335db-bf64-424a-88d7-5c24625c50b1.jpg,Airplane,607,718,1752,1867,111,115
1841,2560,2560,JPEG,RGB,False,1,74d335db-bf64-424a-88d7-5c24625c50b1.jpg,Airplane,906,1022,2024,2140,116,116
1842,2560,2560,JPEG,RGB,False,1,74d335db-bf64-424a-88d7-5c24625c50b1.jpg,Airplane,1105,1151,1568,1640,46,72
1843,2560,2560,JPEG,RGB,False,1,74d335db-bf64-424a-88d7-5c24625c50b1.jpg,Airplane,1169,1218,1546,1614,49,68
1844,2560,2560,JPEG,RGB,False,1,74d335db-bf64-424a-88d7-5c24625c50b1.jpg,Airplane,1243,1287,1521,1588,44,67
1845,2560,2560,JPEG,RGB,False,1,74d335db-bf64-424a-88d7-5c24625c50b1.jpg,Airplane,1503,1565,1404,1474,62,70
1846,2560,2560,JPEG,RGB,False,1,74d335db-bf64-424a-88d7-5c24625c50b1.jpg,Airplane,1633,1697,1341,1418,64,77
1847,2560,2560,JPEG,RGB,False,1,74d335db-bf64-424a-88d7-5c24625c50b1.jpg,Airplane,2322,2381,1163,1237,59,74
1848,2560,2560,JPEG,RGB,False,1,74d335db-bf64-424a-88d7-5c24625c50b1.jpg,Airplane,1953,2016,1305,1359,63,54
1849,2560,2560,JPEG,RGB,False,1,74d335db-bf64-424a-88d7-5c24625c50b1.jpg,Airplane,1767,1834,1522,1574,67,52
1850,2560,2560,JPEG,RGB,False,1,74d335db-bf64-424a-88d7-5c24625c50b1.jpg,Airplane,1199,1260,1982,2040,61,58
1851,2560,2560,JPEG,RGB,False,1,74d335db-bf64-424a-88d7-5c24625c50b1.jpg,Airplane,1013,1093,1820,1875,80,55
1852,2560,2560,JPEG,RGB,False,1,74d335db-bf64-424a-88d7-5c24625c50b1.jpg,Airplane,1329,1405,1928,1987,76,59
1853,2560,2560,JPEG,RGB,False,1,74d335db-bf64-424a-88d7-5c24625c50b1.jpg,Airplane,1883,1947,1707,1763,64,56
1854,2560,2560,JPEG,RGB,False,1,74d335db-bf64-424a-88d7-5c24625c50b1.jpg,Airplane,2034,2102,1510,1566,68,56
1855,2560,2560,JPEG,RGB,False,1,74d335db-bf64-424a-88d7-5c24625c50b1.jpg,Airplane,2003,2072,1437,1493,69,56
1856,2560,2560,JPEG,RGB,False,1,74d335db-bf64-424a-88d7-5c24625c50b1.jpg,Airplane,1978,2038,1377,1427,60,50
1857,2560,2560,JPEG,RGB,False,1,74d335db-bf64-424a-88d7-5c24625c50b1.jpg,Airplane,2170,2230,1162,1219,60,57
1858,2560,2560,JPEG,RGB,False,1,74d335db-bf64-424a-88d7-5c24625c50b1.jpg,Airplane,2249,2313,1381,1430,64,49
1859,2560,2560,JPEG,RGB,False,1,74d335db-bf64-424a-88d7-5c24625c50b1.jpg,Airplane,2277,2340,1450,1503,63,53
1860,2560,2560,JPEG,RGB,False,1,74d335db-bf64-424a-88d7-5c24625c50b1.jpg,Airplane,2309,2368,1526,1570,59,44
1861,2560,2560,JPEG,RGB,False,1,74d335db-bf64-424a-88d7-5c24625c50b1.jpg,Airplane,2339,2398,1593,1644,59,51
1862,2560,2560,JPEG,RGB,False,1,696b9320-7dbe-4c28-bd07-7a73e7a28e64.jpg,Truncated_airplane,0,43,1348,1478,43,130
1863,2560,2560,JPEG,RGB,False,1,696b9320-7dbe-4c28-bd07-7a73e7a28e64.jpg,Airplane,76,192,1130,1255,116,125
1864,2560,2560,JPEG,RGB,False,1,696b9320-7dbe-4c28-bd07-7a73e7a28e64.jpg,Airplane,214,336,1182,1333,122,151
1865,2560,2560,JPEG,RGB,False,1,696b9320-7dbe-4c28-bd07-7a73e7a28e64.jpg,Airplane,350,473,1253,1403,123,150
1866,2560,2560,JPEG,RGB,False,1,696b9320-7dbe-4c28-bd07-7a73e7a28e64.jpg,Airplane,50,171,1425,1574,121,149
1867,2560,2560,JPEG,RGB,False,1,696b9320-7dbe-4c28-bd07-7a73e7a28e64.jpg,Airplane,187,312,1487,1631,125,144
1868,2560,2560,JPEG,RGB,False,1,696b9320-7dbe-4c28-bd07-7a73e7a28e64.jpg,Airplane,343,458,1585,1706,115,121
1869,2560,2560,JPEG,RGB,False,1,696b9320-7dbe-4c28-bd07-7a73e7a28e64.jpg,Truncated_airplane,154,306,2457,2558,152,101
1870,2560,2560,JPEG,RGB,False,1,696b9320-7dbe-4c28-bd07-7a73e7a28e64.jpg,Airplane,569,653,2490,2557,84,67
1871,2560,2560,JPEG,RGB,False,1,696b9320-7dbe-4c28-bd07-7a73e7a28e64.jpg,Airplane,628,710,2367,2438,82,71
1872,2560,2560,JPEG,RGB,False,1,696b9320-7dbe-4c28-bd07-7a73e7a28e64.jpg,Airplane,877,1004,2453,2558,127,105
1873,2560,2560,JPEG,RGB,False,1,696b9320-7dbe-4c28-bd07-7a73e7a28e64.jpg,Airplane,1384,1468,2453,2533,84,80
1874,2560,2560,JPEG,RGB,False,1,696b9320-7dbe-4c28-bd07-7a73e7a28e64.jpg,Airplane,2108,2185,2418,2533,77,115
1875,2560,2560,JPEG,RGB,False,1,696b9320-7dbe-4c28-bd07-7a73e7a28e64.jpg,Airplane,2407,2477,2191,2285,70,94
1876,2560,2560,JPEG,RGB,False,1,696b9320-7dbe-4c28-bd07-7a73e7a28e64.jpg,Airplane,1712,1810,2123,2246,98,123
1877,2560,2560,JPEG,RGB,False,1,696b9320-7dbe-4c28-bd07-7a73e7a28e64.jpg,Airplane,1924,1977,2254,2319,53,65
1878,2560,2560,JPEG,RGB,False,1,696b9320-7dbe-4c28-bd07-7a73e7a28e64.jpg,Airplane,2001,2054,2272,2339,53,67
1879,2560,2560,JPEG,RGB,False,1,696b9320-7dbe-4c28-bd07-7a73e7a28e64.jpg,Airplane,2069,2138,2218,2293,69,75
1880,2560,2560,JPEG,RGB,False,1,696b9320-7dbe-4c28-bd07-7a73e7a28e64.jpg,Airplane,2105,2193,2141,2212,88,71
1881,2560,2560,JPEG,RGB,False,1,696b9320-7dbe-4c28-bd07-7a73e7a28e64.jpg,Airplane,2071,2165,2049,2126,94,77
1882,2560,2560,JPEG,RGB,False,1,696b9320-7dbe-4c28-bd07-7a73e7a28e64.jpg,Airplane,2013,2084,1996,2081,71,85
1883,2560,2560,JPEG,RGB,False,1,696b9320-7dbe-4c28-bd07-7a73e7a28e64.jpg,Airplane,1925,1996,1947,2023,71,76
1884,2560,2560,JPEG,RGB,False,1,696b9320-7dbe-4c28-bd07-7a73e7a28e64.jpg,Airplane,1835,1907,1896,1973,72,77
1885,2560,2560,JPEG,RGB,False,1,696b9320-7dbe-4c28-bd07-7a73e7a28e64.jpg,Airplane,1944,2018,1706,1795,74,89
1886,2560,2560,JPEG,RGB,False,1,696b9320-7dbe-4c28-bd07-7a73e7a28e64.jpg,Airplane,2023,2090,1675,1751,67,76
1887,2560,2560,JPEG,RGB,False,1,696b9320-7dbe-4c28-bd07-7a73e7a28e64.jpg,Airplane,2187,2262,1726,1808,75,82
1888,2560,2560,JPEG,RGB,False,1,696b9320-7dbe-4c28-bd07-7a73e7a28e64.jpg,Airplane,2279,2352,1759,1840,73,81
1889,2560,2560,JPEG,RGB,False,1,696b9320-7dbe-4c28-bd07-7a73e7a28e64.jpg,Airplane,2489,2556,1708,1789,67,81
1890,2560,2560,JPEG,RGB,False,1,696b9320-7dbe-4c28-bd07-7a73e7a28e64.jpg,Airplane,2362,2441,1588,1662,79,74
1891,2560,2560,JPEG,RGB,False,1,696b9320-7dbe-4c28-bd07-7a73e7a28e64.jpg,Airplane,2362,2440,1489,1563,78,74
1892,2560,2560,JPEG,RGB,False,1,696b9320-7dbe-4c28-bd07-7a73e7a28e64.jpg,Airplane,1989,2057,1383,1434,68,51
1893,2560,2560,JPEG,RGB,False,1,696b9320-7dbe-4c28-bd07-7a73e7a28e64.jpg,Airplane,2036,2110,1283,1366,74,83
1894,2560,2560,JPEG,RGB,False,1,696b9320-7dbe-4c28-bd07-7a73e7a28e64.jpg,Airplane,2206,2277,1232,1321,71,89
1895,2560,2560,JPEG,RGB,False,1,696b9320-7dbe-4c28-bd07-7a73e7a28e64.jpg,Airplane,1664,1748,1366,1443,84,77
1896,2560,2560,JPEG,RGB,False,1,696b9320-7dbe-4c28-bd07-7a73e7a28e64.jpg,Airplane,1682,1771,1280,1349,89,69
1897,2560,2560,JPEG,RGB,False,1,696b9320-7dbe-4c28-bd07-7a73e7a28e64.jpg,Airplane,1719,1798,1188,1256,79,68
1898,2560,2560,JPEG,RGB,False,1,696b9320-7dbe-4c28-bd07-7a73e7a28e64.jpg,Airplane,1887,1958,1117,1206,71,89
1899,2560,2560,JPEG,RGB,False,1,696b9320-7dbe-4c28-bd07-7a73e7a28e64.jpg,Airplane,2008,2077,975,1030,69,55
1900,2560,2560,JPEG,RGB,False,1,696b9320-7dbe-4c28-bd07-7a73e7a28e64.jpg,Airplane,1769,1855,1003,1080,86,77
1901,2560,2560,JPEG,RGB,False,1,696b9320-7dbe-4c28-bd07-7a73e7a28e64.jpg,Airplane,1681,1748,949,1033,67,84
1902,2560,2560,JPEG,RGB,False,1,696b9320-7dbe-4c28-bd07-7a73e7a28e64.jpg,Airplane,1542,1667,890,1027,125,137
1903,2560,2560,JPEG,RGB,False,1,696b9320-7dbe-4c28-bd07-7a73e7a28e64.jpg,Airplane,1452,1521,1169,1261,69,92
1904,2560,2560,JPEG,RGB,False,1,696b9320-7dbe-4c28-bd07-7a73e7a28e64.jpg,Airplane,1348,1423,1155,1245,75,90
1905,2560,2560,JPEG,RGB,False,1,696b9320-7dbe-4c28-bd07-7a73e7a28e64.jpg,Airplane,1012,1081,1231,1319,69,88
1906,2560,2560,JPEG,RGB,False,1,696b9320-7dbe-4c28-bd07-7a73e7a28e64.jpg,Airplane,846,912,1385,1461,66,76
1907,2560,2560,JPEG,RGB,False,1,696b9320-7dbe-4c28-bd07-7a73e7a28e64.jpg,Airplane,777,846,1457,1539,69,82
1908,2560,2560,JPEG,RGB,False,1,696b9320-7dbe-4c28-bd07-7a73e7a28e64.jpg,Airplane,484,610,1313,1475,126,162
1909,2560,2560,JPEG,RGB,False,1,696b9320-7dbe-4c28-bd07-7a73e7a28e64.jpg,Airplane,1232,1287,1047,1113,55,66
1910,2560,2560,JPEG,RGB,False,1,696b9320-7dbe-4c28-bd07-7a73e7a28e64.jpg,Airplane,874,950,963,1056,76,93
1911,2560,2560,JPEG,RGB,False,1,696b9320-7dbe-4c28-bd07-7a73e7a28e64.jpg,Airplane,1230,1288,800,847,58,47
1912,2560,2560,JPEG,RGB,False,1,696b9320-7dbe-4c28-bd07-7a73e7a28e64.jpg,Airplane,974,1094,672,810,120,138
1913,2560,2560,JPEG,RGB,False,1,696b9320-7dbe-4c28-bd07-7a73e7a28e64.jpg,Airplane,843,960,599,738,117,139
1914,2560,2560,JPEG,RGB,False,1,696b9320-7dbe-4c28-bd07-7a73e7a28e64.jpg,Airplane,744,791,491,551,47,60
1915,2560,2560,JPEG,RGB,False,1,696b9320-7dbe-4c28-bd07-7a73e7a28e64.jpg,Airplane,553,671,498,637,118,139
1916,2560,2560,JPEG,RGB,False,1,696b9320-7dbe-4c28-bd07-7a73e7a28e64.jpg,Airplane,465,544,544,651,79,107
1917,2560,2560,JPEG,RGB,False,1,696b9320-7dbe-4c28-bd07-7a73e7a28e64.jpg,Airplane,414,499,642,717,85,75
1918,2560,2560,JPEG,RGB,False,1,696b9320-7dbe-4c28-bd07-7a73e7a28e64.jpg,Airplane,381,520,722,851,139,129
1919,2560,2560,JPEG,RGB,False,1,696b9320-7dbe-4c28-bd07-7a73e7a28e64.jpg,Airplane,551,630,788,907,79,119
1920,2560,2560,JPEG,RGB,False,1,fc1ab8ce-e531-46ed-b74b-0374cd58cf2a.jpg,Airplane,1536,1654,687,834,118,147
1921,2560,2560,JPEG,RGB,False,1,fc1ab8ce-e531-46ed-b74b-0374cd58cf2a.jpg,Airplane,1697,1790,760,868,93,108
1922,2560,2560,JPEG,RGB,False,1,fc1ab8ce-e531-46ed-b74b-0374cd58cf2a.jpg,Airplane,2398,2487,1070,1170,89,100
1923,2560,2560,JPEG,RGB,False,1,fc1ab8ce-e531-46ed-b74b-0374cd58cf2a.jpg,Airplane,2270,2359,1295,1391,89,96
1924,2560,2560,JPEG,RGB,False,1,fc1ab8ce-e531-46ed-b74b-0374cd58cf2a.jpg,Airplane,580,679,1053,1143,99,90
1925,2560,2560,JPEG,RGB,False,1,fc1ab8ce-e531-46ed-b74b-0374cd58cf2a.jpg,Airplane,492,592,1178,1269,100,91
1926,2560,2560,JPEG,RGB,False,1,fc1ab8ce-e531-46ed-b74b-0374cd58cf2a.jpg,Airplane,396,586,1299,1461,190,162
1927,2560,2560,JPEG,RGB,False,1,fc1ab8ce-e531-46ed-b74b-0374cd58cf2a.jpg,Airplane,374,480,1472,1561,106,89
1928,2560,2560,JPEG,RGB,False,1,fc1ab8ce-e531-46ed-b74b-0374cd58cf2a.jpg,Airplane,144,242,1362,1452,98,90
1929,2560,2560,JPEG,RGB,False,1,fc1ab8ce-e531-46ed-b74b-0374cd58cf2a.jpg,Airplane,64,194,1505,1597,130,92
1930,2560,2560,JPEG,RGB,False,1,fc1ab8ce-e531-46ed-b74b-0374cd58cf2a.jpg,Airplane,15,115,1639,1738,100,99
1931,2560,2560,JPEG,RGB,False,1,fc1ab8ce-e531-46ed-b74b-0374cd58cf2a.jpg,Airplane,309,401,1612,1696,92,84
1932,2560,2560,JPEG,RGB,False,1,fc1ab8ce-e531-46ed-b74b-0374cd58cf2a.jpg,Airplane,234,349,1749,1841,115,92
1933,2560,2560,JPEG,RGB,False,1,fc1ab8ce-e531-46ed-b74b-0374cd58cf2a.jpg,Airplane,71,264,2053,2211,193,158
1934,2560,2560,JPEG,RGB,False,1,fc1ab8ce-e531-46ed-b74b-0374cd58cf2a.jpg,Airplane,866,953,1052,1174,87,122
1935,2560,2560,JPEG,RGB,False,1,fc1ab8ce-e531-46ed-b74b-0374cd58cf2a.jpg,Airplane,862,1022,1223,1385,160,162
1936,2560,2560,JPEG,RGB,False,1,fc1ab8ce-e531-46ed-b74b-0374cd58cf2a.jpg,Airplane,758,939,1399,1566,181,167
1937,2560,2560,JPEG,RGB,False,1,fc1ab8ce-e531-46ed-b74b-0374cd58cf2a.jpg,Airplane,739,842,1609,1701,103,92
1938,2560,2560,JPEG,RGB,False,1,fc1ab8ce-e531-46ed-b74b-0374cd58cf2a.jpg,Airplane,621,816,1699,1884,195,185
1939,2560,2560,JPEG,RGB,False,1,fc1ab8ce-e531-46ed-b74b-0374cd58cf2a.jpg,Airplane,1028,1224,1745,1916,196,171
1940,2560,2560,JPEG,RGB,False,1,fc1ab8ce-e531-46ed-b74b-0374cd58cf2a.jpg,Airplane,1544,1670,1116,1267,126,151
1941,2560,2560,JPEG,RGB,False,1,fc1ab8ce-e531-46ed-b74b-0374cd58cf2a.jpg,Airplane,1725,1874,1180,1353,149,173
1942,2560,2560,JPEG,RGB,False,1,fc1ab8ce-e531-46ed-b74b-0374cd58cf2a.jpg,Airplane,1875,2019,1253,1405,144,152
1943,2560,2560,JPEG,RGB,False,1,fc1ab8ce-e531-46ed-b74b-0374cd58cf2a.jpg,Airplane,1948,2141,1357,1585,193,228
1944,2560,2560,JPEG,RGB,False,1,fc1ab8ce-e531-46ed-b74b-0374cd58cf2a.jpg,Airplane,1385,1530,1455,1599,145,144
1945,2560,2560,JPEG,RGB,False,1,fc1ab8ce-e531-46ed-b74b-0374cd58cf2a.jpg,Airplane,1570,1688,1525,1667,118,142
1946,2560,2560,JPEG,RGB,False,1,fc1ab8ce-e531-46ed-b74b-0374cd58cf2a.jpg,Airplane,1687,1793,1792,1893,106,101
1947,2560,2560,JPEG,RGB,False,1,fc1ab8ce-e531-46ed-b74b-0374cd58cf2a.jpg,Airplane,1949,2061,2258,2356,112,98
1948,2560,2560,JPEG,RGB,False,1,fc1ab8ce-e531-46ed-b74b-0374cd58cf2a.jpg,Truncated_airplane,0,63,1763,1877,63,114
1949,2560,2560,JPEG,RGB,False,1,fc1ab8ce-e531-46ed-b74b-0374cd58cf2a.jpg,Airplane,76,256,2051,2210,180,159
1950,2560,2560,JPEG,RGB,False,1,fc1ab8ce-e531-46ed-b74b-0374cd58cf2a.jpg,Truncated_airplane,0,64,1766,1877,64,111
1951,2560,2560,JPEG,RGB,False,1,fc1ab8ce-e531-46ed-b74b-0374cd58cf2a.jpg,Airplane,11,113,1646,1735,102,89
1952,2560,2560,JPEG,RGB,False,1,fc1ab8ce-e531-46ed-b74b-0374cd58cf2a.jpg,Airplane,66,188,1502,1594,122,92
1953,2560,2560,JPEG,RGB,False,1,fc1ab8ce-e531-46ed-b74b-0374cd58cf2a.jpg,Airplane,150,238,1365,1452,88,87
1954,2560,2560,JPEG,RGB,False,1,fc1ab8ce-e531-46ed-b74b-0374cd58cf2a.jpg,Airplane,401,583,1301,1459,182,158
1955,2560,2560,JPEG,RGB,False,1,fc1ab8ce-e531-46ed-b74b-0374cd58cf2a.jpg,Airplane,378,477,1472,1559,99,87
1956,2560,2560,JPEG,RGB,False,1,fc1ab8ce-e531-46ed-b74b-0374cd58cf2a.jpg,Airplane,312,401,1617,1694,89,77
1957,2560,2560,JPEG,RGB,False,1,fc1ab8ce-e531-46ed-b74b-0374cd58cf2a.jpg,Airplane,236,346,1754,1843,110,89
1958,2560,2560,JPEG,RGB,False,1,fc1ab8ce-e531-46ed-b74b-0374cd58cf2a.jpg,Airplane,494,593,1180,1267,99,87
1959,2560,2560,JPEG,RGB,False,1,fc1ab8ce-e531-46ed-b74b-0374cd58cf2a.jpg,Airplane,581,680,1054,1141,99,87
1960,2560,2560,JPEG,RGB,False,1,fc1ab8ce-e531-46ed-b74b-0374cd58cf2a.jpg,Airplane,863,954,1054,1173,91,119
1961,2560,2560,JPEG,RGB,False,1,fc1ab8ce-e531-46ed-b74b-0374cd58cf2a.jpg,Airplane,860,1024,1240,1383,164,143
1962,2560,2560,JPEG,RGB,False,1,fc1ab8ce-e531-46ed-b74b-0374cd58cf2a.jpg,Airplane,764,939,1414,1570,175,156
1963,2560,2560,JPEG,RGB,False,1,fc1ab8ce-e531-46ed-b74b-0374cd58cf2a.jpg,Airplane,741,843,1614,1704,102,90
1964,2560,2560,JPEG,RGB,False,1,fc1ab8ce-e531-46ed-b74b-0374cd58cf2a.jpg,Airplane,623,813,1708,1883,190,175
1965,2560,2560,JPEG,RGB,False,1,fc1ab8ce-e531-46ed-b74b-0374cd58cf2a.jpg,Airplane,1027,1220,1751,1915,193,164
1966,2560,2560,JPEG,RGB,False,1,fc1ab8ce-e531-46ed-b74b-0374cd58cf2a.jpg,Airplane,1389,1534,1456,1596,145,140
1967,2560,2560,JPEG,RGB,False,1,fc1ab8ce-e531-46ed-b74b-0374cd58cf2a.jpg,Airplane,1569,1690,1529,1666,121,137
1968,2560,2560,JPEG,RGB,False,1,fc1ab8ce-e531-46ed-b74b-0374cd58cf2a.jpg,Airplane,1690,1795,1794,1892,105,98
1969,2560,2560,JPEG,RGB,False,1,fc1ab8ce-e531-46ed-b74b-0374cd58cf2a.jpg,Airplane,1951,2147,1368,1583,196,215
1970,2560,2560,JPEG,RGB,False,1,fc1ab8ce-e531-46ed-b74b-0374cd58cf2a.jpg,Airplane,1870,2017,1261,1405,147,144
1971,2560,2560,JPEG,RGB,False,1,fc1ab8ce-e531-46ed-b74b-0374cd58cf2a.jpg,Airplane,1729,1875,1183,1351,146,168
1972,2560,2560,JPEG,RGB,False,1,fc1ab8ce-e531-46ed-b74b-0374cd58cf2a.jpg,Airplane,1548,1671,1120,1269,123,149
1973,2560,2560,JPEG,RGB,False,1,fc1ab8ce-e531-46ed-b74b-0374cd58cf2a.jpg,Airplane,1533,1652,692,830,119,138
1974,2560,2560,JPEG,RGB,False,1,fc1ab8ce-e531-46ed-b74b-0374cd58cf2a.jpg,Airplane,1700,1789,761,865,89,104
1975,2560,2560,JPEG,RGB,False,1,fc1ab8ce-e531-46ed-b74b-0374cd58cf2a.jpg,Airplane,2397,2488,1075,1172,91,97
1976,2560,2560,JPEG,RGB,False,1,fc1ab8ce-e531-46ed-b74b-0374cd58cf2a.jpg,Airplane,2270,2357,1298,1396,87,98
1977,2560,2560,JPEG,RGB,False,1,fc1ab8ce-e531-46ed-b74b-0374cd58cf2a.jpg,Airplane,1946,2058,2259,2356,112,97
1978,2560,2560,JPEG,RGB,False,1,4ca65749-67e4-4457-b4e4-89a3f58ce24d.jpg,Airplane,1538,1594,1485,1555,56,70
1979,2560,2560,JPEG,RGB,False,1,4ca65749-67e4-4457-b4e4-89a3f58ce24d.jpg,Airplane,1760,1815,1618,1688,55,70
1980,2560,2560,JPEG,RGB,False,1,4ca65749-67e4-4457-b4e4-89a3f58ce24d.jpg,Airplane,1687,1747,1640,1716,60,76
1981,2560,2560,JPEG,RGB,False,1,4ca65749-67e4-4457-b4e4-89a3f58ce24d.jpg,Airplane,1277,1339,1811,1887,62,76
1982,2560,2560,JPEG,RGB,False,1,4ca65749-67e4-4457-b4e4-89a3f58ce24d.jpg,Airplane,732,789,2036,2104,57,68
1983,2560,2560,JPEG,RGB,False,1,4ca65749-67e4-4457-b4e4-89a3f58ce24d.jpg,Airplane,614,672,2078,2144,58,66
1984,2560,2560,JPEG,RGB,False,1,4ca65749-67e4-4457-b4e4-89a3f58ce24d.jpg,Airplane,540,615,2004,2063,75,59
1985,2560,2560,JPEG,RGB,False,1,4ca65749-67e4-4457-b4e4-89a3f58ce24d.jpg,Airplane,148,203,1774,1841,55,67
1986,2560,2560,JPEG,RGB,False,1,4ca65749-67e4-4457-b4e4-89a3f58ce24d.jpg,Airplane,3,66,1516,1573,63,57
1987,2560,2560,JPEG,RGB,False,1,12210ad7-83f8-4b54-bb4b-e93f8ff6ac1f.jpg,Airplane,465,600,246,405,135,159
1988,2560,2560,JPEG,RGB,False,1,12210ad7-83f8-4b54-bb4b-e93f8ff6ac1f.jpg,Airplane,351,480,685,852,129,167
1989,2560,2560,JPEG,RGB,False,1,12210ad7-83f8-4b54-bb4b-e93f8ff6ac1f.jpg,Airplane,517,642,762,910,125,148
1990,2560,2560,JPEG,RGB,False,1,12210ad7-83f8-4b54-bb4b-e93f8ff6ac1f.jpg,Airplane,885,995,468,606,110,138
1991,2560,2560,JPEG,RGB,False,1,12210ad7-83f8-4b54-bb4b-e93f8ff6ac1f.jpg,Airplane,804,948,1025,1160,144,135
1992,2560,2560,JPEG,RGB,False,1,12210ad7-83f8-4b54-bb4b-e93f8ff6ac1f.jpg,Airplane,574,729,1997,2124,155,127
1993,2560,2560,JPEG,RGB,False,1,12210ad7-83f8-4b54-bb4b-e93f8ff6ac1f.jpg,Airplane,940,1119,1749,1884,179,135
1994,2560,2560,JPEG,RGB,False,1,12210ad7-83f8-4b54-bb4b-e93f8ff6ac1f.jpg,Airplane,1031,1144,2058,2146,113,88
1995,2560,2560,JPEG,RGB,False,1,12210ad7-83f8-4b54-bb4b-e93f8ff6ac1f.jpg,Airplane,1009,1167,2216,2356,158,140
1996,2560,2560,JPEG,RGB,False,1,12210ad7-83f8-4b54-bb4b-e93f8ff6ac1f.jpg,Airplane,1037,1203,2398,2518,166,120
1997,2560,2560,JPEG,RGB,False,1,12210ad7-83f8-4b54-bb4b-e93f8ff6ac1f.jpg,Airplane,1707,1806,2407,2471,99,64
1998,2560,2560,JPEG,RGB,False,1,12210ad7-83f8-4b54-bb4b-e93f8ff6ac1f.jpg,Airplane,1649,1750,1955,2034,101,79
1999,2560,2560,JPEG,RGB,False,1,12210ad7-83f8-4b54-bb4b-e93f8ff6ac1f.jpg,Airplane,1561,1729,1683,1830,168,147
2000,2560,2560,JPEG,RGB,False,1,12210ad7-83f8-4b54-bb4b-e93f8ff6ac1f.jpg,Airplane,1536,1705,1479,1639,169,160
2001,2560,2560,JPEG,RGB,False,1,12210ad7-83f8-4b54-bb4b-e93f8ff6ac1f.jpg,Airplane,1528,1666,1283,1426,138,143
2002,2560,2560,JPEG,RGB,False,1,12210ad7-83f8-4b54-bb4b-e93f8ff6ac1f.jpg,Airplane,1556,1704,934,1076,148,142
2003,2560,2560,JPEG,RGB,False,1,12210ad7-83f8-4b54-bb4b-e93f8ff6ac1f.jpg,Airplane,1630,1773,785,913,143,128
2004,2560,2560,JPEG,RGB,False,1,12210ad7-83f8-4b54-bb4b-e93f8ff6ac1f.jpg,Airplane,1785,1922,615,775,137,160
2005,2560,2560,JPEG,RGB,False,1,12210ad7-83f8-4b54-bb4b-e93f8ff6ac1f.jpg,Airplane,2213,2377,1225,1417,164,192
2006,2560,2560,JPEG,RGB,False,1,12210ad7-83f8-4b54-bb4b-e93f8ff6ac1f.jpg,Airplane,1962,2113,1532,1677,151,145
2007,2560,2560,JPEG,RGB,False,1,12210ad7-83f8-4b54-bb4b-e93f8ff6ac1f.jpg,Airplane,1997,2143,1849,1984,146,135
2008,2560,2560,JPEG,RGB,False,1,12210ad7-83f8-4b54-bb4b-e93f8ff6ac1f.jpg,Airplane,2047,2189,2157,2305,142,148
2009,2560,2560,JPEG,RGB,False,1,12210ad7-83f8-4b54-bb4b-e93f8ff6ac1f.jpg,Airplane,1366,1475,415,522,109,107
2010,2560,2560,JPEG,RGB,False,1,12210ad7-83f8-4b54-bb4b-e93f8ff6ac1f.jpg,Airplane,1617,1729,234,342,112,108
2011,2560,2560,JPEG,RGB,False,1,12210ad7-83f8-4b54-bb4b-e93f8ff6ac1f.jpg,Airplane,1735,1844,130,264,109,134
2012,2560,2560,JPEG,RGB,False,1,12210ad7-83f8-4b54-bb4b-e93f8ff6ac1f.jpg,Airplane,1857,1956,66,151,99,85
2013,2560,2560,JPEG,RGB,False,1,7635d63c-6b97-4c9c-a7dc-27773d42ed4c.jpg,Airplane,461,621,320,514,160,194
2014,2560,2560,JPEG,RGB,False,1,7635d63c-6b97-4c9c-a7dc-27773d42ed4c.jpg,Airplane,2101,2251,263,440,150,177
2015,2560,2560,JPEG,RGB,False,1,7635d63c-6b97-4c9c-a7dc-27773d42ed4c.jpg,Airplane,1920,2086,320,525,166,205
2016,2560,2560,JPEG,RGB,False,1,7635d63c-6b97-4c9c-a7dc-27773d42ed4c.jpg,Airplane,1731,1891,409,597,160,188
2017,2560,2560,JPEG,RGB,False,1,7635d63c-6b97-4c9c-a7dc-27773d42ed4c.jpg,Airplane,1514,1672,485,664,158,179
2018,2560,2560,JPEG,RGB,False,1,7635d63c-6b97-4c9c-a7dc-27773d42ed4c.jpg,Airplane,1300,1472,564,759,172,195
2019,2560,2560,JPEG,RGB,False,1,7635d63c-6b97-4c9c-a7dc-27773d42ed4c.jpg,Airplane,1079,1262,640,844,183,204
2020,2560,2560,JPEG,RGB,False,1,7635d63c-6b97-4c9c-a7dc-27773d42ed4c.jpg,Airplane,881,1061,703,910,180,207
2021,2560,2560,JPEG,RGB,False,1,7635d63c-6b97-4c9c-a7dc-27773d42ed4c.jpg,Airplane,2443,2552,336,435,109,99
2022,2560,2560,JPEG,RGB,False,1,7635d63c-6b97-4c9c-a7dc-27773d42ed4c.jpg,Airplane,2378,2495,467,571,117,104
2023,2560,2560,JPEG,RGB,False,1,7635d63c-6b97-4c9c-a7dc-27773d42ed4c.jpg,Airplane,2116,2297,892,1048,181,156
2024,2560,2560,JPEG,RGB,False,1,7635d63c-6b97-4c9c-a7dc-27773d42ed4c.jpg,Truncated_airplane,2453,2559,859,1020,106,161
2025,2560,2560,JPEG,RGB,False,1,7635d63c-6b97-4c9c-a7dc-27773d42ed4c.jpg,Airplane,2385,2558,1019,1189,173,170
2026,2560,2560,JPEG,RGB,False,1,7635d63c-6b97-4c9c-a7dc-27773d42ed4c.jpg,Airplane,1872,1970,943,1056,98,113
2027,2560,2560,JPEG,RGB,False,1,7635d63c-6b97-4c9c-a7dc-27773d42ed4c.jpg,Airplane,1579,1686,1001,1113,107,112
2028,2560,2560,JPEG,RGB,False,1,7635d63c-6b97-4c9c-a7dc-27773d42ed4c.jpg,Airplane,1421,1530,1057,1166,109,109
2029,2560,2560,JPEG,RGB,False,1,7635d63c-6b97-4c9c-a7dc-27773d42ed4c.jpg,Airplane,2017,2123,1205,1312,106,107
2030,2560,2560,JPEG,RGB,False,1,7635d63c-6b97-4c9c-a7dc-27773d42ed4c.jpg,Airplane,1821,1914,1289,1394,93,105
2031,2560,2560,JPEG,RGB,False,1,7635d63c-6b97-4c9c-a7dc-27773d42ed4c.jpg,Airplane,1644,1736,1339,1458,92,119
2032,2560,2560,JPEG,RGB,False,1,7635d63c-6b97-4c9c-a7dc-27773d42ed4c.jpg,Airplane,1527,1638,1393,1497,111,104
2033,2560,2560,JPEG,RGB,False,1,7635d63c-6b97-4c9c-a7dc-27773d42ed4c.jpg,Airplane,1442,1532,1434,1534,90,100
2034,2560,2560,JPEG,RGB,False,1,7635d63c-6b97-4c9c-a7dc-27773d42ed4c.jpg,Airplane,1333,1432,1479,1579,99,100
2035,2560,2560,JPEG,RGB,False,1,7635d63c-6b97-4c9c-a7dc-27773d42ed4c.jpg,Airplane,1147,1328,1794,1950,181,156
2036,2560,2560,JPEG,RGB,False,1,7635d63c-6b97-4c9c-a7dc-27773d42ed4c.jpg,Airplane,385,497,2124,2221,112,97
2037,2560,2560,JPEG,RGB,False,1,7635d63c-6b97-4c9c-a7dc-27773d42ed4c.jpg,Airplane,803,909,2218,2359,106,141
2038,2560,2560,JPEG,RGB,False,1,7635d63c-6b97-4c9c-a7dc-27773d42ed4c.jpg,Airplane,686,784,2263,2376,98,113
2039,2560,2560,JPEG,RGB,False,1,7635d63c-6b97-4c9c-a7dc-27773d42ed4c.jpg,Airplane,401,526,2355,2497,125,142
2040,2560,2560,JPEG,RGB,False,1,7635d63c-6b97-4c9c-a7dc-27773d42ed4c.jpg,Airplane,310,389,2418,2513,79,95
2041,2560,2560,JPEG,RGB,False,1,7635d63c-6b97-4c9c-a7dc-27773d42ed4c.jpg,Truncated_airplane,969,1169,2390,2556,200,166
2042,2560,2560,JPEG,RGB,False,1,7635d63c-6b97-4c9c-a7dc-27773d42ed4c.jpg,Truncated_airplane,166,267,2484,2556,101,72
2043,2560,2560,JPEG,RGB,False,1,7635d63c-6b97-4c9c-a7dc-27773d42ed4c.jpg,Airplane,465,620,307,506,155,199
2044,2560,2560,JPEG,RGB,False,1,7635d63c-6b97-4c9c-a7dc-27773d42ed4c.jpg,Airplane,882,1055,706,911,173,205
2045,2560,2560,JPEG,RGB,False,1,7635d63c-6b97-4c9c-a7dc-27773d42ed4c.jpg,Airplane,1076,1256,635,840,180,205
2046,2560,2560,JPEG,RGB,False,1,7635d63c-6b97-4c9c-a7dc-27773d42ed4c.jpg,Airplane,1298,1467,567,761,169,194
2047,2560,2560,JPEG,RGB,False,1,7635d63c-6b97-4c9c-a7dc-27773d42ed4c.jpg,Airplane,1512,1670,490,665,158,175
2048,2560,2560,JPEG,RGB,False,1,7635d63c-6b97-4c9c-a7dc-27773d42ed4c.jpg,Airplane,1727,1891,410,597,164,187
2049,2560,2560,JPEG,RGB,False,1,7635d63c-6b97-4c9c-a7dc-27773d42ed4c.jpg,Airplane,1920,2094,323,526,174,203
2050,2560,2560,JPEG,RGB,False,1,7635d63c-6b97-4c9c-a7dc-27773d42ed4c.jpg,Airplane,2100,2251,264,435,151,171
2051,2560,2560,JPEG,RGB,False,1,7635d63c-6b97-4c9c-a7dc-27773d42ed4c.jpg,Airplane,2439,2546,335,430,107,95
2052,2560,2560,JPEG,RGB,False,1,7635d63c-6b97-4c9c-a7dc-27773d42ed4c.jpg,Airplane,2376,2494,479,571,118,92
2053,2560,2560,JPEG,RGB,False,1,7635d63c-6b97-4c9c-a7dc-27773d42ed4c.jpg,Airplane,2119,2286,889,1046,167,157
2054,2560,2560,JPEG,RGB,False,1,7635d63c-6b97-4c9c-a7dc-27773d42ed4c.jpg,Airplane,1877,1969,946,1053,92,107
2055,2560,2560,JPEG,RGB,False,1,7635d63c-6b97-4c9c-a7dc-27773d42ed4c.jpg,Airplane,1584,1678,1001,1110,94,109
2056,2560,2560,JPEG,RGB,False,1,7635d63c-6b97-4c9c-a7dc-27773d42ed4c.jpg,Airplane,1426,1524,1060,1165,98,105
2057,2560,2560,JPEG,RGB,False,1,7635d63c-6b97-4c9c-a7dc-27773d42ed4c.jpg,Airplane,1331,1426,1472,1575,95,103
2058,2560,2560,JPEG,RGB,False,1,7635d63c-6b97-4c9c-a7dc-27773d42ed4c.jpg,Airplane,1435,1531,1431,1538,96,107
2059,2560,2560,JPEG,RGB,False,1,7635d63c-6b97-4c9c-a7dc-27773d42ed4c.jpg,Airplane,1532,1629,1391,1496,97,105
2060,2560,2560,JPEG,RGB,False,1,7635d63c-6b97-4c9c-a7dc-27773d42ed4c.jpg,Airplane,1638,1733,1343,1461,95,118
2061,2560,2560,JPEG,RGB,False,1,7635d63c-6b97-4c9c-a7dc-27773d42ed4c.jpg,Airplane,1822,1914,1290,1394,92,104
2062,2560,2560,JPEG,RGB,False,1,7635d63c-6b97-4c9c-a7dc-27773d42ed4c.jpg,Airplane,2021,2117,1203,1312,96,109
2063,2560,2560,JPEG,RGB,False,1,7635d63c-6b97-4c9c-a7dc-27773d42ed4c.jpg,Airplane,2384,2557,1025,1194,173,169
2064,2560,2560,JPEG,RGB,False,1,7635d63c-6b97-4c9c-a7dc-27773d42ed4c.jpg,Airplane,1151,1327,1794,1950,176,156
2065,2560,2560,JPEG,RGB,False,1,7635d63c-6b97-4c9c-a7dc-27773d42ed4c.jpg,Airplane,388,497,2119,2220,109,101
2066,2560,2560,JPEG,RGB,False,1,7635d63c-6b97-4c9c-a7dc-27773d42ed4c.jpg,Airplane,307,389,2409,2516,82,107
2067,2560,2560,JPEG,RGB,False,1,7635d63c-6b97-4c9c-a7dc-27773d42ed4c.jpg,Airplane,403,528,2355,2496,125,141
2068,2560,2560,JPEG,RGB,False,1,7635d63c-6b97-4c9c-a7dc-27773d42ed4c.jpg,Airplane,688,779,2265,2368,91,103
2069,2560,2560,JPEG,RGB,False,1,7635d63c-6b97-4c9c-a7dc-27773d42ed4c.jpg,Airplane,805,908,2215,2355,103,140
2070,2560,2560,JPEG,RGB,False,1,7635d63c-6b97-4c9c-a7dc-27773d42ed4c.jpg,Truncated_airplane,971,1171,2386,2557,200,171
2071,2560,2560,JPEG,RGB,False,1,7635d63c-6b97-4c9c-a7dc-27773d42ed4c.jpg,Truncated_airplane,2454,2564,862,1021,110,159
2072,2560,2560,JPEG,RGB,False,1,7635d63c-6b97-4c9c-a7dc-27773d42ed4c.jpg,Truncated_airplane,169,264,2480,2557,95,77
2073,2560,2560,JPEG,RGB,False,1,a32efaae-a263-4570-903f-76cf9942742f.jpg,Airplane,41,112,1564,1628,71,64
2074,2560,2560,JPEG,RGB,False,1,a32efaae-a263-4570-903f-76cf9942742f.jpg,Airplane,63,136,1638,1701,73,63
2075,2560,2560,JPEG,RGB,False,1,a32efaae-a263-4570-903f-76cf9942742f.jpg,Airplane,89,157,1710,1776,68,66
2076,2560,2560,JPEG,RGB,False,1,a32efaae-a263-4570-903f-76cf9942742f.jpg,Airplane,132,201,1858,1930,69,72
2077,2560,2560,JPEG,RGB,False,1,a32efaae-a263-4570-903f-76cf9942742f.jpg,Airplane,177,299,1446,1579,122,133
2078,2560,2560,JPEG,RGB,False,1,a32efaae-a263-4570-903f-76cf9942742f.jpg,Airplane,415,475,1562,1647,60,85
2079,2560,2560,JPEG,RGB,False,1,a32efaae-a263-4570-903f-76cf9942742f.jpg,Airplane,487,608,1592,1735,121,143
2080,2560,2560,JPEG,RGB,False,1,a32efaae-a263-4570-903f-76cf9942742f.jpg,Airplane,732,816,1827,1901,84,74
2081,2560,2560,JPEG,RGB,False,1,a32efaae-a263-4570-903f-76cf9942742f.jpg,Airplane,694,767,1926,1995,73,69
2082,2560,2560,JPEG,RGB,False,1,a32efaae-a263-4570-903f-76cf9942742f.jpg,Airplane,960,1108,1967,2078,148,111
2083,2560,2560,JPEG,RGB,False,1,a32efaae-a263-4570-903f-76cf9942742f.jpg,Airplane,1040,1170,1845,1959,130,114
2084,2560,2560,JPEG,RGB,False,1,a32efaae-a263-4570-903f-76cf9942742f.jpg,Airplane,1058,1163,1522,1644,105,122
2085,2560,2560,JPEG,RGB,False,1,a32efaae-a263-4570-903f-76cf9942742f.jpg,Airplane,819,925,1401,1552,106,151
2086,2560,2560,JPEG,RGB,False,1,a32efaae-a263-4570-903f-76cf9942742f.jpg,Airplane,707,808,1353,1478,101,125
2087,2560,2560,JPEG,RGB,False,1,a32efaae-a263-4570-903f-76cf9942742f.jpg,Airplane,580,691,1296,1432,111,136
2088,2560,2560,JPEG,RGB,False,1,a32efaae-a263-4570-903f-76cf9942742f.jpg,Airplane,486,579,1278,1368,93,90
2089,2560,2560,JPEG,RGB,False,1,a32efaae-a263-4570-903f-76cf9942742f.jpg,Airplane,341,459,1113,1224,118,111
2090,2560,2560,JPEG,RGB,False,1,a32efaae-a263-4570-903f-76cf9942742f.jpg,Airplane,507,616,1060,1167,109,107
2091,2560,2560,JPEG,RGB,False,1,a32efaae-a263-4570-903f-76cf9942742f.jpg,Airplane,710,811,1024,1156,101,132
2092,2560,2560,JPEG,RGB,False,1,a32efaae-a263-4570-903f-76cf9942742f.jpg,Airplane,993,1094,1164,1298,101,134
2093,2560,2560,JPEG,RGB,False,1,a32efaae-a263-4570-903f-76cf9942742f.jpg,Airplane,1141,1250,1220,1363,109,143
2094,2560,2560,JPEG,RGB,False,1,a32efaae-a263-4570-903f-76cf9942742f.jpg,Airplane,1415,1538,1328,1467,123,139
2095,2560,2560,JPEG,RGB,False,1,a32efaae-a263-4570-903f-76cf9942742f.jpg,Airplane,1545,1677,1288,1429,132,141
2096,2560,2560,JPEG,RGB,False,1,a32efaae-a263-4570-903f-76cf9942742f.jpg,Airplane,1551,1619,1622,1712,68,90
2097,2560,2560,JPEG,RGB,False,1,a32efaae-a263-4570-903f-76cf9942742f.jpg,Airplane,1643,1762,1562,1695,119,133
2098,2560,2560,JPEG,RGB,False,1,a32efaae-a263-4570-903f-76cf9942742f.jpg,Airplane,1386,1506,1792,1901,120,109
2099,2560,2560,JPEG,RGB,False,1,a32efaae-a263-4570-903f-76cf9942742f.jpg,Airplane,1295,1368,2038,2108,73,70
2100,2560,2560,JPEG,RGB,False,1,a32efaae-a263-4570-903f-76cf9942742f.jpg,Airplane,1291,1403,910,1051,112,141
2101,2560,2560,JPEG,RGB,False,1,a32efaae-a263-4570-903f-76cf9942742f.jpg,Airplane,1808,1882,898,990,74,92
2102,2560,2560,JPEG,RGB,False,1,a32efaae-a263-4570-903f-76cf9942742f.jpg,Airplane,1760,1836,736,805,76,69
2103,2560,2560,JPEG,RGB,False,1,a32efaae-a263-4570-903f-76cf9942742f.jpg,Airplane,2020,2113,725,788,93,63
2104,2560,2560,JPEG,RGB,False,1,a32efaae-a263-4570-903f-76cf9942742f.jpg,Airplane,1991,2079,653,721,88,68
2105,2560,2560,JPEG,RGB,False,1,a32efaae-a263-4570-903f-76cf9942742f.jpg,Airplane,1965,2060,569,645,95,76
2106,2560,2560,JPEG,RGB,False,1,a32efaae-a263-4570-903f-76cf9942742f.jpg,Airplane,2268,2418,495,617,150,122
2107,2560,2560,JPEG,RGB,False,1,a32efaae-a263-4570-903f-76cf9942742f.jpg,Airplane,2318,2460,628,737,142,109
2108,2560,2560,JPEG,RGB,False,1,a32efaae-a263-4570-903f-76cf9942742f.jpg,Airplane,2364,2500,738,856,136,118
2109,2560,2560,JPEG,RGB,False,1,a32efaae-a263-4570-903f-76cf9942742f.jpg,Airplane,2306,2459,893,1027,153,134
2110,2560,2560,JPEG,RGB,False,1,a32efaae-a263-4570-903f-76cf9942742f.jpg,Airplane,2067,2144,1142,1234,77,92
2111,2560,2560,JPEG,RGB,False,1,a32efaae-a263-4570-903f-76cf9942742f.jpg,Airplane,1940,2045,1164,1288,105,124
2112,2560,2560,JPEG,RGB,False,1,a32efaae-a263-4570-903f-76cf9942742f.jpg,Airplane,1808,1920,1208,1327,112,119
2113,2560,2560,JPEG,RGB,False,1,a32efaae-a263-4570-903f-76cf9942742f.jpg,Airplane,2051,2166,1422,1550,115,128
2114,2560,2560,JPEG,RGB,False,1,a32efaae-a263-4570-903f-76cf9942742f.jpg,Airplane,2180,2295,1378,1507,115,129
2115,2560,2560,JPEG,RGB,False,1,a32efaae-a263-4570-903f-76cf9942742f.jpg,Airplane,2325,2432,1338,1454,107,116
2116,2560,2560,JPEG,RGB,False,1,a32efaae-a263-4570-903f-76cf9942742f.jpg,Airplane,1889,2002,1474,1608,113,134
2117,2560,2560,JPEG,RGB,False,1,a32efaae-a263-4570-903f-76cf9942742f.jpg,Airplane,2142,2271,1775,1889,129,114
2118,2560,2560,JPEG,RGB,False,1,a32efaae-a263-4570-903f-76cf9942742f.jpg,Airplane,2172,2316,1903,2021,144,118
2119,2560,2560,JPEG,RGB,False,1,a32efaae-a263-4570-903f-76cf9942742f.jpg,Airplane,1157,1273,2280,2394,116,114
2120,2560,2560,JPEG,RGB,False,1,a32efaae-a263-4570-903f-76cf9942742f.jpg,Airplane,852,979,2218,2326,127,108
2121,2560,2560,JPEG,RGB,False,1,a32efaae-a263-4570-903f-76cf9942742f.jpg,Airplane,616,676,2182,2235,60,53
2122,2560,2560,JPEG,RGB,False,1,34ae857d-6e71-46b9-b694-d9e40fb093bc.jpg,Airplane,12,184,339,521,172,182
2123,2560,2560,JPEG,RGB,False,1,34ae857d-6e71-46b9-b694-d9e40fb093bc.jpg,Airplane,275,484,557,736,209,179
2124,2560,2560,JPEG,RGB,False,1,34ae857d-6e71-46b9-b694-d9e40fb093bc.jpg,Airplane,234,461,791,964,227,173
2125,2560,2560,JPEG,RGB,False,1,34ae857d-6e71-46b9-b694-d9e40fb093bc.jpg,Airplane,1077,1217,339,488,140,149
2126,2560,2560,JPEG,RGB,False,1,34ae857d-6e71-46b9-b694-d9e40fb093bc.jpg,Airplane,911,1079,503,655,168,152
2127,2560,2560,JPEG,RGB,False,1,34ae857d-6e71-46b9-b694-d9e40fb093bc.jpg,Airplane,787,977,668,820,190,152
2128,2560,2560,JPEG,RGB,False,1,34ae857d-6e71-46b9-b694-d9e40fb093bc.jpg,Airplane,723,884,852,1013,161,161
2129,2560,2560,JPEG,RGB,False,1,34ae857d-6e71-46b9-b694-d9e40fb093bc.jpg,Airplane,655,810,1044,1186,155,142
2130,2560,2560,JPEG,RGB,False,1,34ae857d-6e71-46b9-b694-d9e40fb093bc.jpg,Airplane,538,708,1195,1341,170,146
2131,2560,2560,JPEG,RGB,False,1,34ae857d-6e71-46b9-b694-d9e40fb093bc.jpg,Airplane,1656,1810,563,737,154,174
2132,2560,2560,JPEG,RGB,False,1,34ae857d-6e71-46b9-b694-d9e40fb093bc.jpg,Airplane,1395,1568,641,786,173,145
2133,2560,2560,JPEG,RGB,False,1,34ae857d-6e71-46b9-b694-d9e40fb093bc.jpg,Airplane,1297,1473,856,1001,176,145
2134,2560,2560,JPEG,RGB,False,1,34ae857d-6e71-46b9-b694-d9e40fb093bc.jpg,Airplane,1171,1334,1029,1166,163,137
2135,2560,2560,JPEG,RGB,False,1,34ae857d-6e71-46b9-b694-d9e40fb093bc.jpg,Airplane,1044,1208,1195,1310,164,115
2136,2560,2560,JPEG,RGB,False,1,34ae857d-6e71-46b9-b694-d9e40fb093bc.jpg,Airplane,832,1005,1440,1577,173,137
2137,2560,2560,JPEG,RGB,False,1,34ae857d-6e71-46b9-b694-d9e40fb093bc.jpg,Airplane,2270,2416,861,1021,146,160
2138,2560,2560,JPEG,RGB,False,1,34ae857d-6e71-46b9-b694-d9e40fb093bc.jpg,Airplane,2066,2174,1095,1205,108,110
2139,2560,2560,JPEG,RGB,False,1,34ae857d-6e71-46b9-b694-d9e40fb093bc.jpg,Airplane,1705,1818,1068,1192,113,124
2140,2560,2560,JPEG,RGB,False,1,34ae857d-6e71-46b9-b694-d9e40fb093bc.jpg,Airplane,1884,2086,1252,1418,202,166
2141,2560,2560,JPEG,RGB,False,1,34ae857d-6e71-46b9-b694-d9e40fb093bc.jpg,Airplane,1586,1766,1438,1620,180,182
2142,2560,2560,JPEG,RGB,False,1,34ae857d-6e71-46b9-b694-d9e40fb093bc.jpg,Airplane,1405,1566,1556,1719,161,163
2143,2560,2560,JPEG,RGB,False,1,34ae857d-6e71-46b9-b694-d9e40fb093bc.jpg,Airplane,1163,1344,1729,1914,181,185
2144,2560,2560,JPEG,RGB,False,1,34ae857d-6e71-46b9-b694-d9e40fb093bc.jpg,Airplane,856,1044,1714,1895,188,181
2145,2560,2560,JPEG,RGB,False,1,34ae857d-6e71-46b9-b694-d9e40fb093bc.jpg,Airplane,856,992,2115,2268,136,153
2146,2560,2560,JPEG,RGB,False,1,34ae857d-6e71-46b9-b694-d9e40fb093bc.jpg,Airplane,1157,1295,2108,2267,138,159
2147,2560,2560,JPEG,RGB,False,1,34ae857d-6e71-46b9-b694-d9e40fb093bc.jpg,Airplane,1787,1882,1835,1945,95,110
2148,2560,2560,JPEG,RGB,False,1,34ae857d-6e71-46b9-b694-d9e40fb093bc.jpg,Airplane,1912,2003,1839,1955,91,116
2149,2560,2560,JPEG,RGB,False,1,34ae857d-6e71-46b9-b694-d9e40fb093bc.jpg,Airplane,2033,2133,1851,1965,100,114
2150,2560,2560,JPEG,RGB,False,1,34ae857d-6e71-46b9-b694-d9e40fb093bc.jpg,Airplane,2290,2391,2005,2115,101,110
2151,2560,2560,JPEG,RGB,False,1,34ae857d-6e71-46b9-b694-d9e40fb093bc.jpg,Airplane,2252,2353,2175,2274,101,99
2152,2560,2560,JPEG,RGB,False,1,34ae857d-6e71-46b9-b694-d9e40fb093bc.jpg,Airplane,2014,2118,2161,2266,104,105
2153,2560,2560,JPEG,RGB,False,1,34ae857d-6e71-46b9-b694-d9e40fb093bc.jpg,Airplane,1991,2089,2435,2528,98,93
2154,2560,2560,JPEG,RGB,False,1,34ae857d-6e71-46b9-b694-d9e40fb093bc.jpg,Airplane,1871,1975,2434,2539,104,105
2155,2560,2560,JPEG,RGB,False,1,34ae857d-6e71-46b9-b694-d9e40fb093bc.jpg,Airplane,1751,1855,2423,2524,104,101
2156,2560,2560,JPEG,RGB,False,1,34ae857d-6e71-46b9-b694-d9e40fb093bc.jpg,Airplane,1489,1595,2410,2521,106,111
2157,2560,2560,JPEG,RGB,False,1,34ae857d-6e71-46b9-b694-d9e40fb093bc.jpg,Airplane,758,843,2079,2179,85,100
2158,2560,2560,JPEG,RGB,False,1,cc4f3226-c262-409e-a4b2-a576e776f7f4.jpg,Airplane,1335,1417,181,249,82,68
2159,2560,2560,JPEG,RGB,False,1,cc4f3226-c262-409e-a4b2-a576e776f7f4.jpg,Airplane,1233,1303,459,544,70,85
2160,2560,2560,JPEG,RGB,False,1,cc4f3226-c262-409e-a4b2-a576e776f7f4.jpg,Airplane,1709,1784,502,551,75,49
2161,2560,2560,JPEG,RGB,False,1,cc4f3226-c262-409e-a4b2-a576e776f7f4.jpg,Airplane,694,743,506,564,49,58
2162,2560,2560,JPEG,RGB,False,1,cc4f3226-c262-409e-a4b2-a576e776f7f4.jpg,Airplane,556,644,1288,1351,88,63
2163,2560,2560,JPEG,RGB,False,1,cc4f3226-c262-409e-a4b2-a576e776f7f4.jpg,Airplane,571,652,1373,1441,81,68
2164,2560,2560,JPEG,RGB,False,1,cc4f3226-c262-409e-a4b2-a576e776f7f4.jpg,Airplane,547,635,1600,1666,88,66
2165,2560,2560,JPEG,RGB,False,1,cc4f3226-c262-409e-a4b2-a576e776f7f4.jpg,Airplane,540,634,1691,1765,94,74
2166,2560,2560,JPEG,RGB,False,1,cc4f3226-c262-409e-a4b2-a576e776f7f4.jpg,Airplane,825,877,1641,1706,52,65
2167,2560,2560,JPEG,RGB,False,1,cc4f3226-c262-409e-a4b2-a576e776f7f4.jpg,Airplane,557,651,1974,2040,94,66
2168,2560,2560,JPEG,RGB,False,1,cc4f3226-c262-409e-a4b2-a576e776f7f4.jpg,Airplane,558,645,2066,2130,87,64
2169,2560,2560,JPEG,RGB,False,1,cc4f3226-c262-409e-a4b2-a576e776f7f4.jpg,Airplane,552,645,2179,2246,93,67
2170,2560,2560,JPEG,RGB,False,1,cc4f3226-c262-409e-a4b2-a576e776f7f4.jpg,Airplane,560,650,2292,2358,90,66
2171,2560,2560,JPEG,RGB,False,1,cc4f3226-c262-409e-a4b2-a576e776f7f4.jpg,Airplane,811,891,1874,1974,80,100
2172,2560,2560,JPEG,RGB,False,1,cc4f3226-c262-409e-a4b2-a576e776f7f4.jpg,Airplane,797,895,2180,2299,98,119
2173,2560,2560,JPEG,RGB,False,1,cc4f3226-c262-409e-a4b2-a576e776f7f4.jpg,Airplane,946,1042,2049,2122,96,73
2174,2560,2560,JPEG,RGB,False,1,cc4f3226-c262-409e-a4b2-a576e776f7f4.jpg,Airplane,942,1037,2149,2230,95,81
2175,2560,2560,JPEG,RGB,False,1,cc4f3226-c262-409e-a4b2-a576e776f7f4.jpg,Airplane,933,1032,1141,1224,99,83
2176,2560,2560,JPEG,RGB,False,1,cc4f3226-c262-409e-a4b2-a576e776f7f4.jpg,Airplane,1160,1250,858,925,90,67
2177,2560,2560,JPEG,RGB,False,1,cc4f3226-c262-409e-a4b2-a576e776f7f4.jpg,Airplane,1149,1250,1015,1094,101,79
2178,2560,2560,JPEG,RGB,False,1,cc4f3226-c262-409e-a4b2-a576e776f7f4.jpg,Airplane,1176,1260,1582,1650,84,68
2179,2560,2560,JPEG,RGB,False,1,cc4f3226-c262-409e-a4b2-a576e776f7f4.jpg,Airplane,1156,1255,1868,1945,99,77
2180,2560,2560,JPEG,RGB,False,1,cc4f3226-c262-409e-a4b2-a576e776f7f4.jpg,Airplane,1306,1380,1997,2097,74,100
2181,2560,2560,JPEG,RGB,False,1,cc4f3226-c262-409e-a4b2-a576e776f7f4.jpg,Airplane,1301,1381,2206,2303,80,97
2182,2560,2560,JPEG,RGB,False,1,cc4f3226-c262-409e-a4b2-a576e776f7f4.jpg,Airplane,1420,1489,987,1069,69,82
2183,2560,2560,JPEG,RGB,False,1,cc4f3226-c262-409e-a4b2-a576e776f7f4.jpg,Airplane,1538,1636,1211,1276,98,65
2184,2560,2560,JPEG,RGB,False,1,cc4f3226-c262-409e-a4b2-a576e776f7f4.jpg,Airplane,1537,1624,1385,1463,87,78
2185,2560,2560,JPEG,RGB,False,1,cc4f3226-c262-409e-a4b2-a576e776f7f4.jpg,Airplane,1545,1654,1985,2050,109,65
2186,2560,2560,JPEG,RGB,False,1,cc4f3226-c262-409e-a4b2-a576e776f7f4.jpg,Airplane,1541,1647,2171,2238,106,67
2187,2560,2560,JPEG,RGB,False,1,cc4f3226-c262-409e-a4b2-a576e776f7f4.jpg,Airplane,1541,1647,2266,2332,106,66
2188,2560,2560,JPEG,RGB,False,1,cc4f3226-c262-409e-a4b2-a576e776f7f4.jpg,Airplane,1772,1871,1035,1105,99,70
2189,2560,2560,JPEG,RGB,False,1,cc4f3226-c262-409e-a4b2-a576e776f7f4.jpg,Airplane,1772,1871,1311,1382,99,71
2190,2560,2560,JPEG,RGB,False,1,cc4f3226-c262-409e-a4b2-a576e776f7f4.jpg,Airplane,1784,1878,1409,1471,94,62
2191,2560,2560,JPEG,RGB,False,1,cc4f3226-c262-409e-a4b2-a576e776f7f4.jpg,Airplane,1920,1991,1431,1504,71,73
2192,2560,2560,JPEG,RGB,False,1,cc4f3226-c262-409e-a4b2-a576e776f7f4.jpg,Airplane,1770,1863,1712,1772,93,60
2193,2560,2560,JPEG,RGB,False,1,cc4f3226-c262-409e-a4b2-a576e776f7f4.jpg,Airplane,1767,1861,1806,1869,94,63
2194,2560,2560,JPEG,RGB,False,1,cc4f3226-c262-409e-a4b2-a576e776f7f4.jpg,Airplane,1757,1855,1895,1959,98,64
2195,2560,2560,JPEG,RGB,False,1,cc4f3226-c262-409e-a4b2-a576e776f7f4.jpg,Airplane,1767,1861,1988,2053,94,65
2196,2560,2560,JPEG,RGB,False,1,cc4f3226-c262-409e-a4b2-a576e776f7f4.jpg,Airplane,1773,1867,2080,2147,94,67
2197,2560,2560,JPEG,RGB,False,1,cc4f3226-c262-409e-a4b2-a576e776f7f4.jpg,Airplane,1771,1872,2176,2235,101,59
2198,2560,2560,JPEG,RGB,False,1,cc4f3226-c262-409e-a4b2-a576e776f7f4.jpg,Airplane,1784,1869,2261,2324,85,63
2199,2560,2560,JPEG,RGB,False,1,cc4f3226-c262-409e-a4b2-a576e776f7f4.jpg,Airplane,1923,1989,2284,2386,66,102
2200,2560,2560,JPEG,RGB,False,1,cc4f3226-c262-409e-a4b2-a576e776f7f4.jpg,Airplane,2154,2245,1121,1179,91,58
2201,2560,2560,JPEG,RGB,False,1,cc4f3226-c262-409e-a4b2-a576e776f7f4.jpg,Airplane,2413,2492,1022,1092,79,70
2202,2560,2560,JPEG,RGB,False,1,cc4f3226-c262-409e-a4b2-a576e776f7f4.jpg,Airplane,2161,2247,1371,1428,86,57
2203,2560,2560,JPEG,RGB,False,1,cc4f3226-c262-409e-a4b2-a576e776f7f4.jpg,Airplane,2167,2245,1752,1819,78,67
2204,2560,2560,JPEG,RGB,False,1,cc4f3226-c262-409e-a4b2-a576e776f7f4.jpg,Airplane,2166,2247,1918,1983,81,65
2205,2560,2560,JPEG,RGB,False,1,cc4f3226-c262-409e-a4b2-a576e776f7f4.jpg,Airplane,2177,2255,2174,2240,78,66
2206,2560,2560,JPEG,RGB,False,1,cc4f3226-c262-409e-a4b2-a576e776f7f4.jpg,Airplane,2198,2282,2256,2328,84,72
2207,2560,2560,JPEG,RGB,False,1,cc4f3226-c262-409e-a4b2-a576e776f7f4.jpg,Airplane,202,300,2463,2526,98,63
2208,2560,2560,JPEG,RGB,False,1,cc4f3226-c262-409e-a4b2-a576e776f7f4.jpg,Airplane,567,619,937,976,52,39
2209,2560,2560,JPEG,RGB,False,1,5c9e817a-dc4b-42ab-952c-3128e2de12e8.jpg,Airplane,1950,2139,280,436,189,156
2210,2560,2560,JPEG,RGB,False,1,5c9e817a-dc4b-42ab-952c-3128e2de12e8.jpg,Airplane,1990,2182,472,685,192,213
2211,2560,2560,JPEG,RGB,False,1,5c9e817a-dc4b-42ab-952c-3128e2de12e8.jpg,Airplane,1989,2187,722,894,198,172
2212,2560,2560,JPEG,RGB,False,1,5c9e817a-dc4b-42ab-952c-3128e2de12e8.jpg,Airplane,1539,1729,304,453,190,149
2213,2560,2560,JPEG,RGB,False,1,5c9e817a-dc4b-42ab-952c-3128e2de12e8.jpg,Airplane,1555,1758,479,651,203,172
2214,2560,2560,JPEG,RGB,False,1,5c9e817a-dc4b-42ab-952c-3128e2de12e8.jpg,Airplane,1572,1768,671,840,196,169
2215,2560,2560,JPEG,RGB,False,1,5c9e817a-dc4b-42ab-952c-3128e2de12e8.jpg,Airplane,1604,1789,868,1018,185,150
2216,2560,2560,JPEG,RGB,False,1,5c9e817a-dc4b-42ab-952c-3128e2de12e8.jpg,Airplane,876,1048,350,482,172,132
2217,2560,2560,JPEG,RGB,False,1,5c9e817a-dc4b-42ab-952c-3128e2de12e8.jpg,Airplane,898,1061,529,668,163,139
2218,2560,2560,JPEG,RGB,False,1,5c9e817a-dc4b-42ab-952c-3128e2de12e8.jpg,Airplane,467,643,590,743,176,153
2219,2560,2560,JPEG,RGB,False,1,5c9e817a-dc4b-42ab-952c-3128e2de12e8.jpg,Airplane,2067,2269,1344,1568,202,224
2220,2560,2560,JPEG,RGB,False,1,5c9e817a-dc4b-42ab-952c-3128e2de12e8.jpg,Airplane,2079,2287,1574,1789,208,215
2221,2560,2560,JPEG,RGB,False,1,5c9e817a-dc4b-42ab-952c-3128e2de12e8.jpg,Airplane,2090,2293,1806,1978,203,172
2222,2560,2560,JPEG,RGB,False,1,5c9e817a-dc4b-42ab-952c-3128e2de12e8.jpg,Airplane,2108,2288,2042,2212,180,170
2223,2560,2560,JPEG,RGB,False,1,5c9e817a-dc4b-42ab-952c-3128e2de12e8.jpg,Airplane,1632,1820,1370,1531,188,161
2224,2560,2560,JPEG,RGB,False,1,5c9e817a-dc4b-42ab-952c-3128e2de12e8.jpg,Airplane,1643,1841,1568,1718,198,150
2225,2560,2560,JPEG,RGB,False,1,5c9e817a-dc4b-42ab-952c-3128e2de12e8.jpg,Airplane,1664,1841,1739,1889,177,150
2226,2560,2560,JPEG,RGB,False,1,5c9e817a-dc4b-42ab-952c-3128e2de12e8.jpg,Airplane,1686,1860,1926,2081,174,155
2227,2560,2560,JPEG,RGB,False,1,5c9e817a-dc4b-42ab-952c-3128e2de12e8.jpg,Airplane,1701,1887,2112,2257,186,145
2228,2560,2560,JPEG,RGB,False,1,5c9e817a-dc4b-42ab-952c-3128e2de12e8.jpg,Airplane,958,1137,1445,1601,179,156
2229,2560,2560,JPEG,RGB,False,1,5c9e817a-dc4b-42ab-952c-3128e2de12e8.jpg,Airplane,979,1192,1641,1853,213,212
2230,2560,2560,JPEG,RGB,False,1,5c9e817a-dc4b-42ab-952c-3128e2de12e8.jpg,Airplane,993,1207,1901,2057,214,156
2231,2560,2560,JPEG,RGB,False,1,5c9e817a-dc4b-42ab-952c-3128e2de12e8.jpg,Airplane,1004,1212,2110,2276,208,166
2232,2560,2560,JPEG,RGB,False,1,5c9e817a-dc4b-42ab-952c-3128e2de12e8.jpg,Airplane,634,724,2062,2137,90,75
2233,2560,2560,JPEG,RGB,False,1,5c9e817a-dc4b-42ab-952c-3128e2de12e8.jpg,Airplane,597,715,1701,1794,118,93
2234,2560,2560,JPEG,RGB,False,1,5c9e817a-dc4b-42ab-952c-3128e2de12e8.jpg,Airplane,231,344,2086,2210,113,124
2235,2560,2560,JPEG,RGB,False,1,5c9e817a-dc4b-42ab-952c-3128e2de12e8.jpg,Airplane,48,197,2072,2226,149,154
2236,2560,2560,JPEG,RGB,False,1,5c9e817a-dc4b-42ab-952c-3128e2de12e8.jpg,Airplane,36,122,1730,1836,86,106
2237,2560,2560,JPEG,RGB,False,1,5c9e817a-dc4b-42ab-952c-3128e2de12e8.jpg,Airplane,272,377,1590,1676,105,86
2238,2560,2560,JPEG,RGB,False,1,5c9e817a-dc4b-42ab-952c-3128e2de12e8.jpg,Airplane,164,317,1718,1866,153,148
2239,2560,2560,JPEG,RGB,False,1,42f35cf8-66ca-400b-8381-dacc6483bb56.jpg,Airplane,1463,1533,1,61,70,60
2240,2560,2560,JPEG,RGB,False,1,42f35cf8-66ca-400b-8381-dacc6483bb56.jpg,Airplane,2188,2294,36,143,106,107
2241,2560,2560,JPEG,RGB,False,1,42f35cf8-66ca-400b-8381-dacc6483bb56.jpg,Truncated_airplane,2471,2560,239,339,89,100
2242,2560,2560,JPEG,RGB,False,1,42f35cf8-66ca-400b-8381-dacc6483bb56.jpg,Airplane,1201,1300,457,565,99,108
2243,2560,2560,JPEG,RGB,False,1,42f35cf8-66ca-400b-8381-dacc6483bb56.jpg,Airplane,1136,1184,418,488,48,70
2244,2560,2560,JPEG,RGB,False,1,42f35cf8-66ca-400b-8381-dacc6483bb56.jpg,Airplane,1067,1118,388,462,51,74
2245,2560,2560,JPEG,RGB,False,1,42f35cf8-66ca-400b-8381-dacc6483bb56.jpg,Airplane,1032,1130,819,922,98,103
2246,2560,2560,JPEG,RGB,False,1,42f35cf8-66ca-400b-8381-dacc6483bb56.jpg,Airplane,938,997,769,838,59,69
2247,2560,2560,JPEG,RGB,False,1,42f35cf8-66ca-400b-8381-dacc6483bb56.jpg,Airplane,798,897,709,823,99,114
2248,2560,2560,JPEG,RGB,False,1,42f35cf8-66ca-400b-8381-dacc6483bb56.jpg,Airplane,712,811,1048,1152,99,104
2249,2560,2560,JPEG,RGB,False,1,42f35cf8-66ca-400b-8381-dacc6483bb56.jpg,Airplane,581,691,983,1110,110,127
2250,2560,2560,JPEG,RGB,False,1,42f35cf8-66ca-400b-8381-dacc6483bb56.jpg,Airplane,2118,2177,1049,1105,59,56
2251,2560,2560,JPEG,RGB,False,1,42f35cf8-66ca-400b-8381-dacc6483bb56.jpg,Airplane,2090,2150,1116,1172,60,56
2252,2560,2560,JPEG,RGB,False,1,42f35cf8-66ca-400b-8381-dacc6483bb56.jpg,Airplane,2055,2119,1183,1242,64,59
2253,2560,2560,JPEG,RGB,False,1,42f35cf8-66ca-400b-8381-dacc6483bb56.jpg,Airplane,2032,2095,1253,1307,63,54
2254,2560,2560,JPEG,RGB,False,1,42f35cf8-66ca-400b-8381-dacc6483bb56.jpg,Airplane,1973,2030,1386,1445,57,59
2255,2560,2560,JPEG,RGB,False,1,42f35cf8-66ca-400b-8381-dacc6483bb56.jpg,Airplane,1917,1976,1520,1576,59,56
2256,2560,2560,JPEG,RGB,False,1,42f35cf8-66ca-400b-8381-dacc6483bb56.jpg,Airplane,1942,2007,1693,1762,65,69
2257,2560,2560,JPEG,RGB,False,1,42f35cf8-66ca-400b-8381-dacc6483bb56.jpg,Airplane,1861,1921,1655,1711,60,56
2258,2560,2560,JPEG,RGB,False,1,42f35cf8-66ca-400b-8381-dacc6483bb56.jpg,Airplane,1832,1892,1723,1780,60,57
2259,2560,2560,JPEG,RGB,False,1,42f35cf8-66ca-400b-8381-dacc6483bb56.jpg,Airplane,1741,1802,1938,1999,61,61
2260,2560,2560,JPEG,RGB,False,1,42f35cf8-66ca-400b-8381-dacc6483bb56.jpg,Airplane,1681,1742,2080,2135,61,55
2261,2560,2560,JPEG,RGB,False,1,b7ab0316-bf02-4266-b44a-cef6417f795c.jpg,Airplane,1460,1539,311,387,79,76
2262,2560,2560,JPEG,RGB,False,1,b7ab0316-bf02-4266-b44a-cef6417f795c.jpg,Airplane,802,934,2405,2527,132,122
2263,2560,2560,JPEG,RGB,False,1,b7ab0316-bf02-4266-b44a-cef6417f795c.jpg,Airplane,914,1038,2316,2431,124,115
2264,2560,2560,JPEG,RGB,False,1,b7ab0316-bf02-4266-b44a-cef6417f795c.jpg,Airplane,986,1116,2194,2299,130,105
2265,2560,2560,JPEG,RGB,False,1,b7ab0316-bf02-4266-b44a-cef6417f795c.jpg,Airplane,1124,1210,2002,2077,86,75
2266,2560,2560,JPEG,RGB,False,1,b7ab0316-bf02-4266-b44a-cef6417f795c.jpg,Airplane,1174,1300,1591,1722,126,131
2267,2560,2560,JPEG,RGB,False,1,b7ab0316-bf02-4266-b44a-cef6417f795c.jpg,Airplane,973,1055,246,322,82,76
2268,2560,2560,JPEG,RGB,False,1,b7ab0316-bf02-4266-b44a-cef6417f795c.jpg,Truncated_airplane,772,872,1,76,100,75
2269,2560,2560,JPEG,RGB,False,1,b7ab0316-bf02-4266-b44a-cef6417f795c.jpg,Airplane,500,583,118,210,83,92
2270,2560,2560,JPEG,RGB,False,1,d8873734-016a-4b9d-9b9e-8bc47eb13fef.jpg,Airplane,229,404,310,521,175,211
2271,2560,2560,JPEG,RGB,False,1,d8873734-016a-4b9d-9b9e-8bc47eb13fef.jpg,Airplane,275,470,555,728,195,173
2272,2560,2560,JPEG,RGB,False,1,d8873734-016a-4b9d-9b9e-8bc47eb13fef.jpg,Airplane,229,441,788,962,212,174
2273,2560,2560,JPEG,RGB,False,1,d8873734-016a-4b9d-9b9e-8bc47eb13fef.jpg,Airplane,707,874,392,575,167,183
2274,2560,2560,JPEG,RGB,False,1,d8873734-016a-4b9d-9b9e-8bc47eb13fef.jpg,Airplane,1613,1804,292,445,191,153
2275,2560,2560,JPEG,RGB,False,1,d8873734-016a-4b9d-9b9e-8bc47eb13fef.jpg,Airplane,1041,1231,325,484,190,159
2276,2560,2560,JPEG,RGB,False,1,d8873734-016a-4b9d-9b9e-8bc47eb13fef.jpg,Airplane,899,1084,493,656,185,163
2277,2560,2560,JPEG,RGB,False,1,d8873734-016a-4b9d-9b9e-8bc47eb13fef.jpg,Airplane,779,970,661,826,191,165
2278,2560,2560,JPEG,RGB,False,1,d8873734-016a-4b9d-9b9e-8bc47eb13fef.jpg,Airplane,711,883,852,1007,172,155
2279,2560,2560,JPEG,RGB,False,1,d8873734-016a-4b9d-9b9e-8bc47eb13fef.jpg,Airplane,624,820,1028,1197,196,169
2280,2560,2560,JPEG,RGB,False,1,d8873734-016a-4b9d-9b9e-8bc47eb13fef.jpg,Airplane,1502,1673,464,607,171,143
2281,2560,2560,JPEG,RGB,False,1,d8873734-016a-4b9d-9b9e-8bc47eb13fef.jpg,Airplane,1386,1594,631,798,208,167
2282,2560,2560,JPEG,RGB,False,1,d8873734-016a-4b9d-9b9e-8bc47eb13fef.jpg,Airplane,1281,1495,821,1023,214,202
2283,2560,2560,JPEG,RGB,False,1,d8873734-016a-4b9d-9b9e-8bc47eb13fef.jpg,Airplane,1155,1343,1012,1186,188,174
2284,2560,2560,JPEG,RGB,False,1,d8873734-016a-4b9d-9b9e-8bc47eb13fef.jpg,Airplane,2054,2218,801,996,164,195
2285,2560,2560,JPEG,RGB,False,1,d8873734-016a-4b9d-9b9e-8bc47eb13fef.jpg,Airplane,2305,2406,1105,1231,101,126
2286,2560,2560,JPEG,RGB,False,1,d8873734-016a-4b9d-9b9e-8bc47eb13fef.jpg,Airplane,1824,1927,1077,1185,103,108
2287,2560,2560,JPEG,RGB,False,1,d8873734-016a-4b9d-9b9e-8bc47eb13fef.jpg,Airplane,1838,1987,1440,1633,149,193
2288,2560,2560,JPEG,RGB,False,1,d8873734-016a-4b9d-9b9e-8bc47eb13fef.jpg,Airplane,1597,1784,1234,1409,187,175
2289,2560,2560,JPEG,RGB,False,1,d8873734-016a-4b9d-9b9e-8bc47eb13fef.jpg,Airplane,1581,1750,1429,1618,169,189
2290,2560,2560,JPEG,RGB,False,1,d8873734-016a-4b9d-9b9e-8bc47eb13fef.jpg,Airplane,1411,1561,1542,1714,150,172
2291,2560,2560,JPEG,RGB,False,1,d8873734-016a-4b9d-9b9e-8bc47eb13fef.jpg,Airplane,2021,2127,1839,1954,106,115
2292,2560,2560,JPEG,RGB,False,1,d8873734-016a-4b9d-9b9e-8bc47eb13fef.jpg,Airplane,1784,1890,1837,1952,106,115
2293,2560,2560,JPEG,RGB,False,1,d8873734-016a-4b9d-9b9e-8bc47eb13fef.jpg,Airplane,2263,2342,2182,2279,79,97
2294,2560,2560,JPEG,RGB,False,1,d8873734-016a-4b9d-9b9e-8bc47eb13fef.jpg,Airplane,2012,2105,2141,2269,93,128
2295,2560,2560,JPEG,RGB,False,1,d8873734-016a-4b9d-9b9e-8bc47eb13fef.jpg,Airplane,1883,1988,2140,2262,105,122
2296,2560,2560,JPEG,RGB,False,1,d8873734-016a-4b9d-9b9e-8bc47eb13fef.jpg,Airplane,1780,1866,2157,2251,86,94
2297,2560,2560,JPEG,RGB,False,1,d8873734-016a-4b9d-9b9e-8bc47eb13fef.jpg,Airplane,1973,2083,2419,2545,110,126
2298,2560,2560,JPEG,RGB,False,1,d8873734-016a-4b9d-9b9e-8bc47eb13fef.jpg,Airplane,1168,1324,1723,1919,156,196
2299,2560,2560,JPEG,RGB,False,1,d8873734-016a-4b9d-9b9e-8bc47eb13fef.jpg,Airplane,1038,1150,1752,1882,112,130
2300,2560,2560,JPEG,RGB,False,1,d8873734-016a-4b9d-9b9e-8bc47eb13fef.jpg,Airplane,1015,1109,2140,2243,94,103
2301,2560,2560,JPEG,RGB,False,1,d8873734-016a-4b9d-9b9e-8bc47eb13fef.jpg,Airplane,847,990,2107,2281,143,174
2302,2560,2560,JPEG,RGB,False,1,d8873734-016a-4b9d-9b9e-8bc47eb13fef.jpg,Airplane,744,826,2070,2173,82,103
2303,2560,2560,JPEG,RGB,False,1,d8873734-016a-4b9d-9b9e-8bc47eb13fef.jpg,Truncated_airplane,1053,1167,2481,2559,114,78
2304,2560,2560,JPEG,RGB,False,1,495b73c8-024f-46cc-b426-05e49bbe5074.jpg,Airplane,369,556,242,407,187,165
2305,2560,2560,JPEG,RGB,False,1,495b73c8-024f-46cc-b426-05e49bbe5074.jpg,Airplane,338,516,598,749,178,151
2306,2560,2560,JPEG,RGB,False,1,495b73c8-024f-46cc-b426-05e49bbe5074.jpg,Airplane,701,837,486,635,136,149
2307,2560,2560,JPEG,RGB,False,1,495b73c8-024f-46cc-b426-05e49bbe5074.jpg,Airplane,876,1049,462,656,173,194
2308,2560,2560,JPEG,RGB,False,1,495b73c8-024f-46cc-b426-05e49bbe5074.jpg,Airplane,1412,1515,469,552,103,83
2309,2560,2560,JPEG,RGB,False,1,495b73c8-024f-46cc-b426-05e49bbe5074.jpg,Airplane,1545,1647,594,682,102,88
2310,2560,2560,JPEG,RGB,False,1,495b73c8-024f-46cc-b426-05e49bbe5074.jpg,Airplane,1012,1176,603,746,164,143
2311,2560,2560,JPEG,RGB,False,1,495b73c8-024f-46cc-b426-05e49bbe5074.jpg,Airplane,348,524,830,995,176,165
2312,2560,2560,JPEG,RGB,False,1,495b73c8-024f-46cc-b426-05e49bbe5074.jpg,Airplane,632,832,1093,1265,200,172
2313,2560,2560,JPEG,RGB,False,1,495b73c8-024f-46cc-b426-05e49bbe5074.jpg,Airplane,980,1143,1162,1305,163,143
2314,2560,2560,JPEG,RGB,False,1,495b73c8-024f-46cc-b426-05e49bbe5074.jpg,Airplane,1229,1385,914,1044,156,130
2315,2560,2560,JPEG,RGB,False,1,495b73c8-024f-46cc-b426-05e49bbe5074.jpg,Airplane,2166,2363,0,169,197,169
2316,2560,2560,JPEG,RGB,False,1,495b73c8-024f-46cc-b426-05e49bbe5074.jpg,Airplane,322,501,1362,1526,179,164
2317,2560,2560,JPEG,RGB,False,1,495b73c8-024f-46cc-b426-05e49bbe5074.jpg,Airplane,570,749,1312,1466,179,154
2318,2560,2560,JPEG,RGB,False,1,495b73c8-024f-46cc-b426-05e49bbe5074.jpg,Airplane,679,841,1497,1641,162,144
2319,2560,2560,JPEG,RGB,False,1,495b73c8-024f-46cc-b426-05e49bbe5074.jpg,Airplane,449,614,1744,1887,165,143
2320,2560,2560,JPEG,RGB,False,1,495b73c8-024f-46cc-b426-05e49bbe5074.jpg,Airplane,790,980,1655,1808,190,153
2321,2560,2560,JPEG,RGB,False,1,495b73c8-024f-46cc-b426-05e49bbe5074.jpg,Airplane,543,732,1917,2077,189,160
2322,2560,2560,JPEG,RGB,False,1,495b73c8-024f-46cc-b426-05e49bbe5074.jpg,Airplane,686,848,2087,2225,162,138
2323,2560,2560,JPEG,RGB,False,1,495b73c8-024f-46cc-b426-05e49bbe5074.jpg,Airplane,801,960,2260,2390,159,130
2324,2560,2560,JPEG,RGB,False,1,495b73c8-024f-46cc-b426-05e49bbe5074.jpg,Airplane,2335,2430,2261,2374,95,113
2325,2560,2560,JPEG,RGB,False,1,495b73c8-024f-46cc-b426-05e49bbe5074.jpg,Airplane,1986,2205,2259,2473,219,214
2326,2560,2560,JPEG,RGB,False,1,495b73c8-024f-46cc-b426-05e49bbe5074.jpg,Airplane,1601,1699,2122,2212,98,90
2327,2560,2560,JPEG,RGB,False,1,495b73c8-024f-46cc-b426-05e49bbe5074.jpg,Airplane,1526,1627,2024,2115,101,91
2328,2560,2560,JPEG,RGB,False,1,495b73c8-024f-46cc-b426-05e49bbe5074.jpg,Airplane,1072,1258,1319,1472,186,153
2329,2560,2560,JPEG,RGB,False,1,495b73c8-024f-46cc-b426-05e49bbe5074.jpg,Airplane,1206,1362,1468,1611,156,143
2330,2560,2560,JPEG,RGB,False,1,495b73c8-024f-46cc-b426-05e49bbe5074.jpg,Truncated_airplane,2324,2367,2533,2560,43,27
2331,2560,2560,JPEG,RGB,False,1,d9399a45-6745-4e59-8903-90640b2ddf9f.jpg,Airplane,2226,2363,364,486,137,122
2332,2560,2560,JPEG,RGB,False,1,d9399a45-6745-4e59-8903-90640b2ddf9f.jpg,Airplane,2301,2453,610,737,152,127
2333,2560,2560,JPEG,RGB,False,1,d9399a45-6745-4e59-8903-90640b2ddf9f.jpg,Airplane,2363,2492,741,860,129,119
2334,2560,2560,JPEG,RGB,False,1,d9399a45-6745-4e59-8903-90640b2ddf9f.jpg,Airplane,1966,2055,567,646,89,79
2335,2560,2560,JPEG,RGB,False,1,d9399a45-6745-4e59-8903-90640b2ddf9f.jpg,Airplane,1985,2072,647,715,87,68
2336,2560,2560,JPEG,RGB,False,1,d9399a45-6745-4e59-8903-90640b2ddf9f.jpg,Airplane,2052,2135,805,873,83,68
2337,2560,2560,JPEG,RGB,False,1,d9399a45-6745-4e59-8903-90640b2ddf9f.jpg,Airplane,1960,2034,847,921,74,74
2338,2560,2560,JPEG,RGB,False,1,d9399a45-6745-4e59-8903-90640b2ddf9f.jpg,Airplane,1751,1836,738,810,85,72
2339,2560,2560,JPEG,RGB,False,1,d9399a45-6745-4e59-8903-90640b2ddf9f.jpg,Airplane,1776,1860,815,880,84,65
2340,2560,2560,JPEG,RGB,False,1,d9399a45-6745-4e59-8903-90640b2ddf9f.jpg,Airplane,1806,1877,898,975,71,77
2341,2560,2560,JPEG,RGB,False,1,d9399a45-6745-4e59-8903-90640b2ddf9f.jpg,Airplane,2299,2381,1046,1137,82,91
2342,2560,2560,JPEG,RGB,False,1,d9399a45-6745-4e59-8903-90640b2ddf9f.jpg,Airplane,2313,2425,1333,1458,112,125
2343,2560,2560,JPEG,RGB,False,1,d9399a45-6745-4e59-8903-90640b2ddf9f.jpg,Airplane,2192,2268,1116,1193,76,77
2344,2560,2560,JPEG,RGB,False,1,d9399a45-6745-4e59-8903-90640b2ddf9f.jpg,Airplane,2069,2144,1155,1237,75,82
2345,2560,2560,JPEG,RGB,False,1,d9399a45-6745-4e59-8903-90640b2ddf9f.jpg,Airplane,2173,2293,1383,1503,120,120
2346,2560,2560,JPEG,RGB,False,1,d9399a45-6745-4e59-8903-90640b2ddf9f.jpg,Airplane,2052,2172,1425,1550,120,125
2347,2560,2560,JPEG,RGB,False,1,d9399a45-6745-4e59-8903-90640b2ddf9f.jpg,Airplane,1761,1883,1527,1642,122,115
2348,2560,2560,JPEG,RGB,False,1,d9399a45-6745-4e59-8903-90640b2ddf9f.jpg,Airplane,1547,1622,1626,1704,75,78
2349,2560,2560,JPEG,RGB,False,1,d9399a45-6745-4e59-8903-90640b2ddf9f.jpg,Airplane,1917,2046,1138,1291,129,153
2350,2560,2560,JPEG,RGB,False,1,d9399a45-6745-4e59-8903-90640b2ddf9f.jpg,Airplane,1817,1900,1222,1319,83,97
2351,2560,2560,JPEG,RGB,False,1,d9399a45-6745-4e59-8903-90640b2ddf9f.jpg,Airplane,1663,1794,1237,1381,131,144
2352,2560,2560,JPEG,RGB,False,1,d9399a45-6745-4e59-8903-90640b2ddf9f.jpg,Airplane,1553,1638,1324,1423,85,99
2353,2560,2560,JPEG,RGB,False,1,d9399a45-6745-4e59-8903-90640b2ddf9f.jpg,Airplane,1425,1546,1337,1466,121,129
2354,2560,2560,JPEG,RGB,False,1,d9399a45-6745-4e59-8903-90640b2ddf9f.jpg,Airplane,850,975,1069,1224,125,155
2355,2560,2560,JPEG,RGB,False,1,d9399a45-6745-4e59-8903-90640b2ddf9f.jpg,Airplane,989,1096,1170,1304,107,134
2356,2560,2560,JPEG,RGB,False,1,d9399a45-6745-4e59-8903-90640b2ddf9f.jpg,Airplane,461,576,1263,1373,115,110
2357,2560,2560,JPEG,RGB,False,1,d9399a45-6745-4e59-8903-90640b2ddf9f.jpg,Airplane,693,805,1353,1497,112,144
2358,2560,2560,JPEG,RGB,False,1,d9399a45-6745-4e59-8903-90640b2ddf9f.jpg,Airplane,825,924,1416,1532,99,116
2359,2560,2560,JPEG,RGB,False,1,d9399a45-6745-4e59-8903-90640b2ddf9f.jpg,Airplane,778,857,1749,1817,79,68
2360,2560,2560,JPEG,RGB,False,1,d9399a45-6745-4e59-8903-90640b2ddf9f.jpg,Airplane,636,726,2018,2078,90,60
2361,2560,2560,JPEG,RGB,False,1,d9399a45-6745-4e59-8903-90640b2ddf9f.jpg,Airplane,612,677,2176,2228,65,52
2362,2560,2560,JPEG,RGB,False,1,d9399a45-6745-4e59-8903-90640b2ddf9f.jpg,Airplane,1088,1228,1704,1833,140,129
2363,2560,2560,JPEG,RGB,False,1,d9399a45-6745-4e59-8903-90640b2ddf9f.jpg,Airplane,1029,1160,1842,1956,131,114
2364,2560,2560,JPEG,RGB,False,1,d9399a45-6745-4e59-8903-90640b2ddf9f.jpg,Airplane,911,1043,2094,2207,132,113
2365,2560,2560,JPEG,RGB,False,1,d9399a45-6745-4e59-8903-90640b2ddf9f.jpg,Airplane,866,960,2262,2332,94,70
2366,2560,2560,JPEG,RGB,False,1,d9399a45-6745-4e59-8903-90640b2ddf9f.jpg,Airplane,798,923,2336,2450,125,114
2367,2560,2560,JPEG,RGB,False,1,d9399a45-6745-4e59-8903-90640b2ddf9f.jpg,Airplane,1445,1578,2387,2508,133,121
2368,2560,2560,JPEG,RGB,False,1,d9399a45-6745-4e59-8903-90640b2ddf9f.jpg,Airplane,1849,1933,1931,2007,84,76
2369,2560,2560,JPEG,RGB,False,1,d9399a45-6745-4e59-8903-90640b2ddf9f.jpg,Airplane,1875,1990,2030,2140,115,110
2370,2560,2560,JPEG,RGB,False,1,d9399a45-6745-4e59-8903-90640b2ddf9f.jpg,Airplane,1728,1799,1929,2010,71,81
2371,2560,2560,JPEG,RGB,False,1,d9399a45-6745-4e59-8903-90640b2ddf9f.jpg,Airplane,1720,1804,2046,2123,84,77
2372,2560,2560,JPEG,RGB,False,1,d9399a45-6745-4e59-8903-90640b2ddf9f.jpg,Airplane,1321,1448,1914,2027,127,113
2373,2560,2560,JPEG,RGB,False,1,d9399a45-6745-4e59-8903-90640b2ddf9f.jpg,Airplane,1299,1437,2059,2169,138,110
2374,2560,2560,JPEG,RGB,False,1,d9399a45-6745-4e59-8903-90640b2ddf9f.jpg,Airplane,1171,1251,2292,2350,80,58
2375,2560,2560,JPEG,RGB,False,1,d9399a45-6745-4e59-8903-90640b2ddf9f.jpg,Airplane,2133,2208,668,759,75,91
2376,2560,2560,JPEG,RGB,False,1,d9399a45-6745-4e59-8903-90640b2ddf9f.jpg,Airplane,469,575,1269,1372,106,103
2377,2560,2560,JPEG,RGB,False,1,d9399a45-6745-4e59-8903-90640b2ddf9f.jpg,Airplane,854,974,1075,1227,120,152
2378,2560,2560,JPEG,RGB,False,1,d9399a45-6745-4e59-8903-90640b2ddf9f.jpg,Airplane,994,1096,1170,1299,102,129
2379,2560,2560,JPEG,RGB,False,1,d9399a45-6745-4e59-8903-90640b2ddf9f.jpg,Airplane,696,805,1361,1491,109,130
2380,2560,2560,JPEG,RGB,False,1,d9399a45-6745-4e59-8903-90640b2ddf9f.jpg,Airplane,827,925,1421,1535,98,114
2381,2560,2560,JPEG,RGB,False,1,d9399a45-6745-4e59-8903-90640b2ddf9f.jpg,Airplane,779,854,1749,1813,75,64
2382,2560,2560,JPEG,RGB,False,1,d9399a45-6745-4e59-8903-90640b2ddf9f.jpg,Airplane,649,723,2020,2083,74,63
2383,2560,2560,JPEG,RGB,False,1,d9399a45-6745-4e59-8903-90640b2ddf9f.jpg,Airplane,618,674,2181,2229,56,48
2384,2560,2560,JPEG,RGB,False,1,d9399a45-6745-4e59-8903-90640b2ddf9f.jpg,Airplane,915,1036,2096,2203,121,107
2385,2560,2560,JPEG,RGB,False,1,d9399a45-6745-4e59-8903-90640b2ddf9f.jpg,Airplane,883,954,2266,2329,71,63
2386,2560,2560,JPEG,RGB,False,1,d9399a45-6745-4e59-8903-90640b2ddf9f.jpg,Airplane,802,916,2344,2447,114,103
2387,2560,2560,JPEG,RGB,False,1,d9399a45-6745-4e59-8903-90640b2ddf9f.jpg,Airplane,1179,1249,2293,2353,70,60
2388,2560,2560,JPEG,RGB,False,1,d9399a45-6745-4e59-8903-90640b2ddf9f.jpg,Airplane,1301,1435,2062,2170,134,108
2389,2560,2560,JPEG,RGB,False,1,d9399a45-6745-4e59-8903-90640b2ddf9f.jpg,Airplane,1329,1448,1918,2025,119,107
2390,2560,2560,JPEG,RGB,False,1,d9399a45-6745-4e59-8903-90640b2ddf9f.jpg,Airplane,1451,1576,2396,2506,125,110
2391,2560,2560,JPEG,RGB,False,1,d9399a45-6745-4e59-8903-90640b2ddf9f.jpg,Airplane,1723,1803,2054,2120,80,66
2392,2560,2560,JPEG,RGB,False,1,d9399a45-6745-4e59-8903-90640b2ddf9f.jpg,Airplane,1732,1801,1938,2009,69,71
2393,2560,2560,JPEG,RGB,False,1,d9399a45-6745-4e59-8903-90640b2ddf9f.jpg,Airplane,1879,1989,2036,2140,110,104
2394,2560,2560,JPEG,RGB,False,1,d9399a45-6745-4e59-8903-90640b2ddf9f.jpg,Airplane,1553,1617,1632,1706,64,74
2395,2560,2560,JPEG,RGB,False,1,d9399a45-6745-4e59-8903-90640b2ddf9f.jpg,Airplane,1567,1633,1328,1409,66,81
2396,2560,2560,JPEG,RGB,False,1,d9399a45-6745-4e59-8903-90640b2ddf9f.jpg,Airplane,1671,1788,1236,1378,117,142
2397,2560,2560,JPEG,RGB,False,1,d9399a45-6745-4e59-8903-90640b2ddf9f.jpg,Airplane,2140,2211,667,757,71,90
2398,2560,2560,JPEG,RGB,False,1,d9399a45-6745-4e59-8903-90640b2ddf9f.jpg,Airplane,2074,2137,1157,1239,63,82
2399,2560,2560,JPEG,RGB,False,1,d9399a45-6745-4e59-8903-90640b2ddf9f.jpg,Airplane,2200,2263,1119,1193,63,74
2400,2560,2560,JPEG,RGB,False,1,d9399a45-6745-4e59-8903-90640b2ddf9f.jpg,Airplane,2303,2374,1050,1135,71,85
2401,2560,2560,JPEG,RGB,False,1,d9399a45-6745-4e59-8903-90640b2ddf9f.jpg,Airplane,2181,2290,1389,1502,109,113
2402,2560,2560,JPEG,RGB,False,1,d9399a45-6745-4e59-8903-90640b2ddf9f.jpg,Airplane,2057,2164,1429,1549,107,120
2403,2560,2560,JPEG,RGB,False,1,d9399a45-6745-4e59-8903-90640b2ddf9f.jpg,Airplane,1767,1876,1531,1646,109,115
2404,2560,2560,JPEG,RGB,False,1,d9399a45-6745-4e59-8903-90640b2ddf9f.jpg,Airplane,2319,2425,1345,1461,106,116
2405,2560,2560,JPEG,RGB,False,1,d9399a45-6745-4e59-8903-90640b2ddf9f.jpg,Airplane,2308,2450,623,734,142,111
2406,2560,2560,JPEG,RGB,False,1,d9399a45-6745-4e59-8903-90640b2ddf9f.jpg,Airplane,2368,2492,748,857,124,109
2407,2560,2560,JPEG,RGB,False,1,d9399a45-6745-4e59-8903-90640b2ddf9f.jpg,Airplane,2233,2360,375,484,127,109
2408,2560,2560,JPEG,RGB,False,1,d9399a45-6745-4e59-8903-90640b2ddf9f.jpg,Airplane,1760,1842,742,808,82,66
2409,2560,2560,JPEG,RGB,False,1,d9399a45-6745-4e59-8903-90640b2ddf9f.jpg,Airplane,1783,1861,821,879,78,58
2410,2560,2560,JPEG,RGB,False,1,d9399a45-6745-4e59-8903-90640b2ddf9f.jpg,Airplane,1812,1876,904,974,64,70
2411,2560,2560,JPEG,RGB,False,1,d9399a45-6745-4e59-8903-90640b2ddf9f.jpg,Airplane,1966,2032,851,923,66,72
2412,2560,2560,JPEG,RGB,False,1,d9399a45-6745-4e59-8903-90640b2ddf9f.jpg,Airplane,2061,2130,808,874,69,66
2413,2560,2560,JPEG,RGB,False,1,d9399a45-6745-4e59-8903-90640b2ddf9f.jpg,Airplane,1994,2071,654,715,77,61
2414,2560,2560,JPEG,RGB,False,1,d9399a45-6745-4e59-8903-90640b2ddf9f.jpg,Airplane,1971,2048,578,644,77,66
2415,2560,2560,JPEG,RGB,False,1,d9399a45-6745-4e59-8903-90640b2ddf9f.jpg,Airplane,1930,2048,1148,1292,118,144
2416,2560,2560,JPEG,RGB,False,1,d9399a45-6745-4e59-8903-90640b2ddf9f.jpg,Airplane,1822,1888,1226,1316,66,90
2417,2560,2560,JPEG,RGB,False,1,d9399a45-6745-4e59-8903-90640b2ddf9f.jpg,Airplane,1430,1538,1338,1466,108,128
2418,2560,2560,JPEG,RGB,False,1,d9399a45-6745-4e59-8903-90640b2ddf9f.jpg,Airplane,1039,1157,1848,1957,118,109
2419,2560,2560,JPEG,RGB,False,1,d9399a45-6745-4e59-8903-90640b2ddf9f.jpg,Airplane,1092,1224,1714,1830,132,116
2420,2560,2560,JPEG,RGB,False,1,d9399a45-6745-4e59-8903-90640b2ddf9f.jpg,Airplane,1852,1929,1937,2004,77,67
2421,2560,2560,JPEG,RGB,False,1,d9399a45-6745-4e59-8903-90640b2ddf9f.jpg,Airplane,112,150,1815,1850,38,35
2422,2560,2560,JPEG,RGB,False,1,d9399a45-6745-4e59-8903-90640b2ddf9f.jpg,Airplane,2148,2205,672,754,57,82
2423,2560,2560,JPEG,RGB,False,1,a40b7aed-8db8-449d-b0e4-3debfa04281a.jpg,Airplane,246,377,69,195,131,126
2424,2560,2560,JPEG,RGB,False,1,a40b7aed-8db8-449d-b0e4-3debfa04281a.jpg,Airplane,587,690,403,474,103,71
2425,2560,2560,JPEG,RGB,False,1,a40b7aed-8db8-449d-b0e4-3debfa04281a.jpg,Airplane,629,725,537,611,96,74
2426,2560,2560,JPEG,RGB,False,1,a40b7aed-8db8-449d-b0e4-3debfa04281a.jpg,Airplane,880,1034,325,454,154,129
2427,2560,2560,JPEG,RGB,False,1,a40b7aed-8db8-449d-b0e4-3debfa04281a.jpg,Airplane,966,1079,488,606,113,118
2428,2560,2560,JPEG,RGB,False,1,a40b7aed-8db8-449d-b0e4-3debfa04281a.jpg,Airplane,1050,1173,767,887,123,120
2429,2560,2560,JPEG,RGB,False,1,a40b7aed-8db8-449d-b0e4-3debfa04281a.jpg,Airplane,716,806,794,864,90,70
2430,2560,2560,JPEG,RGB,False,1,a40b7aed-8db8-449d-b0e4-3debfa04281a.jpg,Airplane,759,849,918,990,90,72
2431,2560,2560,JPEG,RGB,False,1,a40b7aed-8db8-449d-b0e4-3debfa04281a.jpg,Airplane,1089,1215,907,1025,126,118
2432,2560,2560,JPEG,RGB,False,1,a40b7aed-8db8-449d-b0e4-3debfa04281a.jpg,Airplane,1122,1273,1050,1174,151,124
2433,2560,2560,JPEG,RGB,False,1,a40b7aed-8db8-449d-b0e4-3debfa04281a.jpg,Airplane,1182,1306,1190,1305,124,115
2434,2560,2560,JPEG,RGB,False,1,a40b7aed-8db8-449d-b0e4-3debfa04281a.jpg,Airplane,849,932,1168,1232,83,64
2435,2560,2560,JPEG,RGB,False,1,a40b7aed-8db8-449d-b0e4-3debfa04281a.jpg,Airplane,802,887,1040,1113,85,73
2436,2560,2560,JPEG,RGB,False,1,a40b7aed-8db8-449d-b0e4-3debfa04281a.jpg,Airplane,976,1019,1433,1471,43,38
2437,2560,2560,JPEG,RGB,False,1,a40b7aed-8db8-449d-b0e4-3debfa04281a.jpg,Airplane,978,1063,1550,1619,85,69
2438,2560,2560,JPEG,RGB,False,1,a40b7aed-8db8-449d-b0e4-3debfa04281a.jpg,Airplane,1164,1283,1627,1753,119,126
2439,2560,2560,JPEG,RGB,False,1,a40b7aed-8db8-449d-b0e4-3debfa04281a.jpg,Airplane,1306,1460,1610,1729,154,119
2440,2560,2560,JPEG,RGB,False,1,a40b7aed-8db8-449d-b0e4-3debfa04281a.jpg,Airplane,1469,1544,2137,2204,75,67
2441,2560,2560,JPEG,RGB,False,1,a40b7aed-8db8-449d-b0e4-3debfa04281a.jpg,Airplane,1122,1221,2186,2252,99,66
2442,2560,2560,JPEG,RGB,False,1,a40b7aed-8db8-449d-b0e4-3debfa04281a.jpg,Airplane,1154,1229,2285,2347,75,62
2443,2560,2560,JPEG,RGB,False,1,a40b7aed-8db8-449d-b0e4-3debfa04281a.jpg,Airplane,1184,1262,2362,2422,78,60
2444,2560,2560,JPEG,RGB,False,1,a40b7aed-8db8-449d-b0e4-3debfa04281a.jpg,Airplane,1547,1642,2378,2436,95,58
2445,2560,2560,JPEG,RGB,False,1,a40b7aed-8db8-449d-b0e4-3debfa04281a.jpg,Airplane,1578,1656,2462,2519,78,57
2446,2560,2560,JPEG,RGB,False,1,4a0821b7-3689-4b0e-9397-389254ea9a32.jpg,Airplane,158,226,216,303,68,87
2447,2560,2560,JPEG,RGB,False,1,4a0821b7-3689-4b0e-9397-389254ea9a32.jpg,Airplane,288,380,540,608,92,68
2448,2560,2560,JPEG,RGB,False,1,4a0821b7-3689-4b0e-9397-389254ea9a32.jpg,Airplane,1032,1081,592,665,49,73
2449,2560,2560,JPEG,RGB,False,1,4a0821b7-3689-4b0e-9397-389254ea9a32.jpg,Airplane,965,1004,641,697,39,56
2450,2560,2560,JPEG,RGB,False,1,4a0821b7-3689-4b0e-9397-389254ea9a32.jpg,Airplane,1641,1687,723,797,46,74
2451,2560,2560,JPEG,RGB,False,1,4a0821b7-3689-4b0e-9397-389254ea9a32.jpg,Airplane,1714,1779,709,791,65,82
2452,2560,2560,JPEG,RGB,False,1,4a0821b7-3689-4b0e-9397-389254ea9a32.jpg,Airplane,1795,1866,694,780,71,86
2453,2560,2560,JPEG,RGB,False,1,4a0821b7-3689-4b0e-9397-389254ea9a32.jpg,Airplane,1886,1941,713,783,55,70
2454,2560,2560,JPEG,RGB,False,1,4a0821b7-3689-4b0e-9397-389254ea9a32.jpg,Airplane,2329,2415,84,162,86,78
2455,2560,2560,JPEG,RGB,False,1,4a0821b7-3689-4b0e-9397-389254ea9a32.jpg,Airplane,2380,2468,174,243,88,69
2456,2560,2560,JPEG,RGB,False,1,4a0821b7-3689-4b0e-9397-389254ea9a32.jpg,Airplane,2325,2405,328,388,80,60
2457,2560,2560,JPEG,RGB,False,1,4a0821b7-3689-4b0e-9397-389254ea9a32.jpg,Airplane,2259,2344,411,476,85,65
2458,2560,2560,JPEG,RGB,False,1,4a0821b7-3689-4b0e-9397-389254ea9a32.jpg,Airplane,2228,2294,490,556,66,66
2459,2560,2560,JPEG,RGB,False,1,4a0821b7-3689-4b0e-9397-389254ea9a32.jpg,Airplane,2151,2220,539,612,69,73
2460,2560,2560,JPEG,RGB,False,1,4a0821b7-3689-4b0e-9397-389254ea9a32.jpg,Airplane,2052,2111,680,760,59,80
2461,2560,2560,JPEG,RGB,False,1,4a0821b7-3689-4b0e-9397-389254ea9a32.jpg,Airplane,1960,2026,683,771,66,88
2462,2560,2560,JPEG,RGB,False,1,4a0821b7-3689-4b0e-9397-389254ea9a32.jpg,Airplane,2168,2246,761,860,78,99
2463,2560,2560,JPEG,RGB,False,1,4a0821b7-3689-4b0e-9397-389254ea9a32.jpg,Airplane,2322,2383,717,793,61,76
2464,2560,2560,JPEG,RGB,False,1,4a0821b7-3689-4b0e-9397-389254ea9a32.jpg,Airplane,2375,2445,1071,1137,70,66
2465,2560,2560,JPEG,RGB,False,1,4a0821b7-3689-4b0e-9397-389254ea9a32.jpg,Airplane,2473,2529,1210,1271,56,61
2466,2560,2560,JPEG,RGB,False,1,4a0821b7-3689-4b0e-9397-389254ea9a32.jpg,Airplane,2277,2353,1361,1423,76,62
2467,2560,2560,JPEG,RGB,False,1,4a0821b7-3689-4b0e-9397-389254ea9a32.jpg,Airplane,2297,2373,1455,1519,76,64
2468,2560,2560,JPEG,RGB,False,1,4a0821b7-3689-4b0e-9397-389254ea9a32.jpg,Airplane,2306,2389,1553,1626,83,73
2469,2560,2560,JPEG,RGB,False,1,4a0821b7-3689-4b0e-9397-389254ea9a32.jpg,Airplane,2299,2365,1667,1724,66,57
2470,2560,2560,JPEG,RGB,False,1,4a0821b7-3689-4b0e-9397-389254ea9a32.jpg,Airplane,2461,2510,2023,2092,49,69
2471,2560,2560,JPEG,RGB,False,1,4a0821b7-3689-4b0e-9397-389254ea9a32.jpg,Airplane,2409,2484,2101,2172,75,71
2472,2560,2560,JPEG,RGB,False,1,4a0821b7-3689-4b0e-9397-389254ea9a32.jpg,Airplane,2316,2381,2251,2312,65,61
2473,2560,2560,JPEG,RGB,False,1,4a0821b7-3689-4b0e-9397-389254ea9a32.jpg,Airplane,2264,2355,2324,2397,91,73
2474,2560,2560,JPEG,RGB,False,1,4a0821b7-3689-4b0e-9397-389254ea9a32.jpg,Airplane,2402,2471,2405,2476,69,71
2475,2560,2560,JPEG,RGB,False,1,4a0821b7-3689-4b0e-9397-389254ea9a32.jpg,Airplane,2063,2133,2215,2303,70,88
2476,2560,2560,JPEG,RGB,False,1,4a0821b7-3689-4b0e-9397-389254ea9a32.jpg,Airplane,2228,2289,2025,2083,61,58
2477,2560,2560,JPEG,RGB,False,1,4a0821b7-3689-4b0e-9397-389254ea9a32.jpg,Airplane,1924,1962,2315,2385,38,70
2478,2560,2560,JPEG,RGB,False,1,4a0821b7-3689-4b0e-9397-389254ea9a32.jpg,Airplane,1837,1878,2334,2397,41,63
2479,2560,2560,JPEG,RGB,False,1,4a0821b7-3689-4b0e-9397-389254ea9a32.jpg,Airplane,1610,1659,2345,2405,49,60
2480,2560,2560,JPEG,RGB,False,1,4a0821b7-3689-4b0e-9397-389254ea9a32.jpg,Truncated_airplane,0,41,324,422,41,98
2481,2560,2560,JPEG,RGB,False,1,71252436-5176-40ba-b1ff-73efc251f3c6.jpg,Airplane,187,249,213,290,62,77
2482,2560,2560,JPEG,RGB,False,1,71252436-5176-40ba-b1ff-73efc251f3c6.jpg,Airplane,493,606,404,538,113,134
2483,2560,2560,JPEG,RGB,False,1,71252436-5176-40ba-b1ff-73efc251f3c6.jpg,Airplane,784,827,543,585,43,42
2484,2560,2560,JPEG,RGB,False,1,71252436-5176-40ba-b1ff-73efc251f3c6.jpg,Airplane,837,883,578,638,46,60
2485,2560,2560,JPEG,RGB,False,1,71252436-5176-40ba-b1ff-73efc251f3c6.jpg,Airplane,749,796,585,633,47,48
2486,2560,2560,JPEG,RGB,False,1,71252436-5176-40ba-b1ff-73efc251f3c6.jpg,Airplane,944,1003,669,745,59,76
2487,2560,2560,JPEG,RGB,False,1,71252436-5176-40ba-b1ff-73efc251f3c6.jpg,Airplane,1034,1072,704,747,38,43
2488,2560,2560,JPEG,RGB,False,1,71252436-5176-40ba-b1ff-73efc251f3c6.jpg,Airplane,1087,1124,730,774,37,44
2489,2560,2560,JPEG,RGB,False,1,71252436-5176-40ba-b1ff-73efc251f3c6.jpg,Airplane,1050,1102,768,818,52,50
2490,2560,2560,JPEG,RGB,False,1,71252436-5176-40ba-b1ff-73efc251f3c6.jpg,Airplane,1230,1275,824,875,45,51
2491,2560,2560,JPEG,RGB,False,1,71252436-5176-40ba-b1ff-73efc251f3c6.jpg,Airplane,1578,1646,710,773,68,63
2492,2560,2560,JPEG,RGB,False,1,71252436-5176-40ba-b1ff-73efc251f3c6.jpg,Airplane,1686,1753,1144,1216,67,72
2493,2560,2560,JPEG,RGB,False,1,71252436-5176-40ba-b1ff-73efc251f3c6.jpg,Truncated_airplane,2487,2562,708,820,75,112
2494,2560,2560,JPEG,RGB,False,1,71252436-5176-40ba-b1ff-73efc251f3c6.jpg,Airplane,2400,2511,823,963,111,140
2495,2560,2560,JPEG,RGB,False,1,71252436-5176-40ba-b1ff-73efc251f3c6.jpg,Airplane,2259,2391,1008,1145,132,137
2496,2560,2560,JPEG,RGB,False,1,71252436-5176-40ba-b1ff-73efc251f3c6.jpg,Airplane,2379,2512,1572,1715,133,143
2497,2560,2560,JPEG,RGB,False,1,71252436-5176-40ba-b1ff-73efc251f3c6.jpg,Airplane,2328,2465,1456,1589,137,133
2498,2560,2560,JPEG,RGB,False,1,71252436-5176-40ba-b1ff-73efc251f3c6.jpg,Airplane,407,489,2154,2229,82,75
2499,2560,2560,JPEG,RGB,False,1,71252436-5176-40ba-b1ff-73efc251f3c6.jpg,Truncated_airplane,2502,2569,1575,1697,67,122
2500,2560,2560,JPEG,RGB,False,1,71252436-5176-40ba-b1ff-73efc251f3c6.jpg,Airplane,1316,1348,888,925,32,37
2501,2560,2560,JPEG,RGB,False,1,71252436-5176-40ba-b1ff-73efc251f3c6.jpg,Airplane,1273,1305,926,956,32,30
2502,2560,2560,JPEG,RGB,False,1,71252436-5176-40ba-b1ff-73efc251f3c6.jpg,Airplane,1049,1077,822,852,28,30
2503,2560,2560,JPEG,RGB,False,1,71252436-5176-40ba-b1ff-73efc251f3c6.jpg,Airplane,1003,1037,751,797,34,46
2504,2560,2560,JPEG,RGB,False,1,20bfce20-fb8a-4e20-a4aa-57064add848b.jpg,Airplane,1397,1475,225,312,78,87
2505,2560,2560,JPEG,RGB,False,1,20bfce20-fb8a-4e20-a4aa-57064add848b.jpg,Airplane,967,1044,253,327,77,74
2506,2560,2560,JPEG,RGB,False,1,20bfce20-fb8a-4e20-a4aa-57064add848b.jpg,Airplane,492,559,254,321,67,67
2507,2560,2560,JPEG,RGB,False,1,20bfce20-fb8a-4e20-a4aa-57064add848b.jpg,Airplane,420,480,263,337,60,74
2508,2560,2560,JPEG,RGB,False,1,20bfce20-fb8a-4e20-a4aa-57064add848b.jpg,Airplane,802,929,2398,2522,127,124
2509,2560,2560,JPEG,RGB,False,1,20bfce20-fb8a-4e20-a4aa-57064add848b.jpg,Airplane,1050,1128,364,436,78,72
2510,2560,2560,JPEG,RGB,False,1,20bfce20-fb8a-4e20-a4aa-57064add848b.jpg,Airplane,1108,1195,455,531,87,76
2511,2560,2560,JPEG,RGB,False,1,20bfce20-fb8a-4e20-a4aa-57064add848b.jpg,Airplane,1252,1328,1041,1127,76,86
2512,2560,2560,JPEG,RGB,False,1,20bfce20-fb8a-4e20-a4aa-57064add848b.jpg,Airplane,1199,1285,1164,1242,86,78
2513,2560,2560,JPEG,RGB,False,1,20bfce20-fb8a-4e20-a4aa-57064add848b.jpg,Airplane,1131,1233,1400,1483,102,83
2514,2560,2560,JPEG,RGB,False,1,20bfce20-fb8a-4e20-a4aa-57064add848b.jpg,Airplane,1128,1222,1508,1587,94,79
2515,2560,2560,JPEG,RGB,False,1,20bfce20-fb8a-4e20-a4aa-57064add848b.jpg,Airplane,1167,1304,1597,1723,137,126
2516,2560,2560,JPEG,RGB,False,1,20bfce20-fb8a-4e20-a4aa-57064add848b.jpg,Airplane,1153,1234,1873,1943,81,70
2517,2560,2560,JPEG,RGB,False,1,20bfce20-fb8a-4e20-a4aa-57064add848b.jpg,Airplane,979,1114,2183,2300,135,117
2518,2560,2560,JPEG,RGB,False,1,20bfce20-fb8a-4e20-a4aa-57064add848b.jpg,Airplane,1357,1502,2145,2284,145,139
2519,2560,2560,JPEG,RGB,False,1,8df07836-4606-446e-9880-6ed9e0f74543.jpg,Airplane,1044,1153,277,378,109,101
2520,2560,2560,JPEG,RGB,False,1,8df07836-4606-446e-9880-6ed9e0f74543.jpg,Airplane,1720,1901,463,672,181,209
2521,2560,2560,JPEG,RGB,False,1,8df07836-4606-446e-9880-6ed9e0f74543.jpg,Airplane,1511,1669,587,734,158,147
2522,2560,2560,JPEG,RGB,False,1,8df07836-4606-446e-9880-6ed9e0f74543.jpg,Airplane,1129,1267,767,906,138,139
2523,2560,2560,JPEG,RGB,False,1,8df07836-4606-446e-9880-6ed9e0f74543.jpg,Airplane,1017,1170,610,749,153,139
2524,2560,2560,JPEG,RGB,False,1,8df07836-4606-446e-9880-6ed9e0f74543.jpg,Airplane,872,1053,460,664,181,204
2525,2560,2560,JPEG,RGB,False,1,8df07836-4606-446e-9880-6ed9e0f74543.jpg,Airplane,683,864,467,666,181,199
2526,2560,2560,JPEG,RGB,False,1,8df07836-4606-446e-9880-6ed9e0f74543.jpg,Airplane,489,668,468,673,179,205
2527,2560,2560,JPEG,RGB,False,1,8df07836-4606-446e-9880-6ed9e0f74543.jpg,Airplane,321,516,594,756,195,162
2528,2560,2560,JPEG,RGB,False,1,8df07836-4606-446e-9880-6ed9e0f74543.jpg,Airplane,326,540,828,1009,214,181
2529,2560,2560,JPEG,RGB,False,1,8df07836-4606-446e-9880-6ed9e0f74543.jpg,Airplane,672,843,842,1038,171,196
2530,2560,2560,JPEG,RGB,False,1,8df07836-4606-446e-9880-6ed9e0f74543.jpg,Airplane,1197,1365,1474,1622,168,148
2531,2560,2560,JPEG,RGB,False,1,8df07836-4606-446e-9880-6ed9e0f74543.jpg,Airplane,868,1051,1007,1171,183,164
2532,2560,2560,JPEG,RGB,False,1,8df07836-4606-446e-9880-6ed9e0f74543.jpg,Airplane,985,1145,1164,1328,160,164
2533,2560,2560,JPEG,RGB,False,1,8df07836-4606-446e-9880-6ed9e0f74543.jpg,Airplane,1090,1259,1324,1467,169,143
2534,2560,2560,JPEG,RGB,False,1,8df07836-4606-446e-9880-6ed9e0f74543.jpg,Truncated_airplane,2486,2559,2312,2466,73,154
2535,2560,2560,JPEG,RGB,False,1,8df07836-4606-446e-9880-6ed9e0f74543.jpg,Airplane,2335,2427,2264,2399,92,135
2536,2560,2560,JPEG,RGB,False,1,8df07836-4606-446e-9880-6ed9e0f74543.jpg,Airplane,2225,2324,2363,2469,99,106
2537,2560,2560,JPEG,RGB,False,1,8df07836-4606-446e-9880-6ed9e0f74543.jpg,Airplane,2009,2188,2261,2478,179,217
2538,2560,2560,JPEG,RGB,False,1,8df07836-4606-446e-9880-6ed9e0f74543.jpg,Airplane,1601,1703,2127,2221,102,94
2539,2560,2560,JPEG,RGB,False,1,8df07836-4606-446e-9880-6ed9e0f74543.jpg,Airplane,1533,1632,2028,2117,99,89
2540,2560,2560,JPEG,RGB,False,1,8df07836-4606-446e-9880-6ed9e0f74543.jpg,Airplane,666,861,1499,1651,195,152
2541,2560,2560,JPEG,RGB,False,1,8df07836-4606-446e-9880-6ed9e0f74543.jpg,Airplane,796,962,1670,1823,166,153
2542,2560,2560,JPEG,RGB,False,1,8df07836-4606-446e-9880-6ed9e0f74543.jpg,Airplane,925,1083,1832,1989,158,157
2543,2560,2560,JPEG,RGB,False,1,8df07836-4606-446e-9880-6ed9e0f74543.jpg,Airplane,331,489,1587,1727,158,140
2544,2560,2560,JPEG,RGB,False,1,8df07836-4606-446e-9880-6ed9e0f74543.jpg,Airplane,468,620,1747,1895,152,148
2545,2560,2560,JPEG,RGB,False,1,8df07836-4606-446e-9880-6ed9e0f74543.jpg,Airplane,580,725,1926,2051,145,125
2546,2560,2560,JPEG,RGB,False,1,8df07836-4606-446e-9880-6ed9e0f74543.jpg,Airplane,702,845,2095,2221,143,126
2547,2560,2560,JPEG,RGB,False,1,8df07836-4606-446e-9880-6ed9e0f74543.jpg,Airplane,787,956,2265,2409,169,144
2548,2560,2560,JPEG,RGB,False,1,fc06c595-7905-46c3-91c0-daf56af0f926.jpg,Airplane,1170,1289,157,301,119,144
2549,2560,2560,JPEG,RGB,False,1,fc06c595-7905-46c3-91c0-daf56af0f926.jpg,Airplane,1370,1495,402,537,125,135
2550,2560,2560,JPEG,RGB,False,1,fc06c595-7905-46c3-91c0-daf56af0f926.jpg,Airplane,1104,1225,559,688,121,129
2551,2560,2560,JPEG,RGB,False,1,fc06c595-7905-46c3-91c0-daf56af0f926.jpg,Airplane,861,989,519,629,128,110
2552,2560,2560,JPEG,RGB,False,1,fc06c595-7905-46c3-91c0-daf56af0f926.jpg,Airplane,831,956,699,853,125,154
2553,2560,2560,JPEG,RGB,False,1,fc06c595-7905-46c3-91c0-daf56af0f926.jpg,Airplane,676,796,798,944,120,146
2554,2560,2560,JPEG,RGB,False,1,fc06c595-7905-46c3-91c0-daf56af0f926.jpg,Airplane,564,663,892,1017,99,125
2555,2560,2560,JPEG,RGB,False,1,fc06c595-7905-46c3-91c0-daf56af0f926.jpg,Airplane,426,544,965,1105,118,140
2556,2560,2560,JPEG,RGB,False,1,fc06c595-7905-46c3-91c0-daf56af0f926.jpg,Airplane,1865,1945,1108,1191,80,83
2557,2560,2560,JPEG,RGB,False,1,fc06c595-7905-46c3-91c0-daf56af0f926.jpg,Airplane,1112,1252,993,1127,140,134
2558,2560,2560,JPEG,RGB,False,1,fc06c595-7905-46c3-91c0-daf56af0f926.jpg,Airplane,1193,1329,1129,1267,136,138
2559,2560,2560,JPEG,RGB,False,1,fc06c595-7905-46c3-91c0-daf56af0f926.jpg,Airplane,1260,1414,1264,1390,154,126
2560,2560,2560,JPEG,RGB,False,1,fc06c595-7905-46c3-91c0-daf56af0f926.jpg,Airplane,1361,1487,1406,1532,126,126
2561,2560,2560,JPEG,RGB,False,1,fc06c595-7905-46c3-91c0-daf56af0f926.jpg,Airplane,1424,1573,1534,1666,149,132
2562,2560,2560,JPEG,RGB,False,1,fc06c595-7905-46c3-91c0-daf56af0f926.jpg,Airplane,1495,1646,1664,1795,151,131
2563,2560,2560,JPEG,RGB,False,1,fc06c595-7905-46c3-91c0-daf56af0f926.jpg,Airplane,1578,1709,1798,1917,131,119
2564,2560,2560,JPEG,RGB,False,1,fc06c595-7905-46c3-91c0-daf56af0f926.jpg,Airplane,1674,1800,1949,2079,126,130
2565,2560,2560,JPEG,RGB,False,1,fc06c595-7905-46c3-91c0-daf56af0f926.jpg,Airplane,2371,2468,1976,2102,97,126
2566,2560,2560,JPEG,RGB,False,1,fc06c595-7905-46c3-91c0-daf56af0f926.jpg,Airplane,1786,1950,2271,2404,164,133
2567,2560,2560,JPEG,RGB,False,1,980b5831-43b7-4adb-9e4b-67d6cff3ef68.jpg,Airplane,163,260,66,145,97,79
2568,2560,2560,JPEG,RGB,False,1,980b5831-43b7-4adb-9e4b-67d6cff3ef68.jpg,Airplane,352,406,133,204,54,71
2569,2560,2560,JPEG,RGB,False,1,980b5831-43b7-4adb-9e4b-67d6cff3ef68.jpg,Airplane,744,793,206,274,49,68
2570,2560,2560,JPEG,RGB,False,1,980b5831-43b7-4adb-9e4b-67d6cff3ef68.jpg,Airplane,681,737,204,287,56,83
2571,2560,2560,JPEG,RGB,False,1,980b5831-43b7-4adb-9e4b-67d6cff3ef68.jpg,Airplane,607,664,213,296,57,83
2572,2560,2560,JPEG,RGB,False,1,980b5831-43b7-4adb-9e4b-67d6cff3ef68.jpg,Airplane,531,588,212,291,57,79
2573,2560,2560,JPEG,RGB,False,1,980b5831-43b7-4adb-9e4b-67d6cff3ef68.jpg,Airplane,885,939,361,443,54,82
2574,2560,2560,JPEG,RGB,False,1,980b5831-43b7-4adb-9e4b-67d6cff3ef68.jpg,Airplane,827,883,381,469,56,88
2575,2560,2560,JPEG,RGB,False,1,980b5831-43b7-4adb-9e4b-67d6cff3ef68.jpg,Airplane,716,772,408,488,56,80
2576,2560,2560,JPEG,RGB,False,1,980b5831-43b7-4adb-9e4b-67d6cff3ef68.jpg,Airplane,656,715,427,511,59,84
2577,2560,2560,JPEG,RGB,False,1,980b5831-43b7-4adb-9e4b-67d6cff3ef68.jpg,Airplane,550,598,497,563,48,66
2578,2560,2560,JPEG,RGB,False,1,980b5831-43b7-4adb-9e4b-67d6cff3ef68.jpg,Airplane,498,548,422,492,50,70
2579,2560,2560,JPEG,RGB,False,1,980b5831-43b7-4adb-9e4b-67d6cff3ef68.jpg,Airplane,446,493,425,493,47,68
2580,2560,2560,JPEG,RGB,False,1,980b5831-43b7-4adb-9e4b-67d6cff3ef68.jpg,Airplane,386,436,427,489,50,62
2581,2560,2560,JPEG,RGB,False,1,980b5831-43b7-4adb-9e4b-67d6cff3ef68.jpg,Airplane,251,310,478,528,59,50
2582,2560,2560,JPEG,RGB,False,1,980b5831-43b7-4adb-9e4b-67d6cff3ef68.jpg,Airplane,237,317,530,576,80,46
2583,2560,2560,JPEG,RGB,False,1,980b5831-43b7-4adb-9e4b-67d6cff3ef68.jpg,Airplane,286,347,571,616,61,45
2584,2560,2560,JPEG,RGB,False,1,980b5831-43b7-4adb-9e4b-67d6cff3ef68.jpg,Airplane,156,212,569,648,56,79
2585,2560,2560,JPEG,RGB,False,1,980b5831-43b7-4adb-9e4b-67d6cff3ef68.jpg,Airplane,468,522,597,644,54,47
2586,2560,2560,JPEG,RGB,False,1,980b5831-43b7-4adb-9e4b-67d6cff3ef68.jpg,Airplane,446,509,672,721,63,49
2587,2560,2560,JPEG,RGB,False,1,980b5831-43b7-4adb-9e4b-67d6cff3ef68.jpg,Airplane,387,442,839,883,55,44
2588,2560,2560,JPEG,RGB,False,1,980b5831-43b7-4adb-9e4b-67d6cff3ef68.jpg,Airplane,350,422,887,935,72,48
2589,2560,2560,JPEG,RGB,False,1,980b5831-43b7-4adb-9e4b-67d6cff3ef68.jpg,Airplane,322,380,929,988,58,59
2590,2560,2560,JPEG,RGB,False,1,980b5831-43b7-4adb-9e4b-67d6cff3ef68.jpg,Airplane,221,278,967,1060,57,93
2591,2560,2560,JPEG,RGB,False,1,980b5831-43b7-4adb-9e4b-67d6cff3ef68.jpg,Airplane,123,208,1045,1105,85,60
2592,2560,2560,JPEG,RGB,False,1,980b5831-43b7-4adb-9e4b-67d6cff3ef68.jpg,Airplane,304,373,1082,1133,69,51
2593,2560,2560,JPEG,RGB,False,1,980b5831-43b7-4adb-9e4b-67d6cff3ef68.jpg,Airplane,310,384,1134,1184,74,50
2594,2560,2560,JPEG,RGB,False,1,980b5831-43b7-4adb-9e4b-67d6cff3ef68.jpg,Airplane,342,407,1240,1290,65,50
2595,2560,2560,JPEG,RGB,False,1,980b5831-43b7-4adb-9e4b-67d6cff3ef68.jpg,Airplane,357,431,1291,1345,74,54
2596,2560,2560,JPEG,RGB,False,1,980b5831-43b7-4adb-9e4b-67d6cff3ef68.jpg,Airplane,1,39,1322,1395,38,73
2597,2560,2560,JPEG,RGB,False,1,980b5831-43b7-4adb-9e4b-67d6cff3ef68.jpg,Airplane,146,212,1358,1407,66,49
2598,2560,2560,JPEG,RGB,False,1,980b5831-43b7-4adb-9e4b-67d6cff3ef68.jpg,Airplane,163,227,1476,1524,64,48
2599,2560,2560,JPEG,RGB,False,1,980b5831-43b7-4adb-9e4b-67d6cff3ef68.jpg,Airplane,205,264,1545,1595,59,50
2600,2560,2560,JPEG,RGB,False,1,980b5831-43b7-4adb-9e4b-67d6cff3ef68.jpg,Airplane,250,301,1607,1646,51,39
2601,2560,2560,JPEG,RGB,False,1,980b5831-43b7-4adb-9e4b-67d6cff3ef68.jpg,Airplane,286,349,1659,1707,63,48
2602,2560,2560,JPEG,RGB,False,1,980b5831-43b7-4adb-9e4b-67d6cff3ef68.jpg,Airplane,425,492,1430,1484,67,54
2603,2560,2560,JPEG,RGB,False,1,980b5831-43b7-4adb-9e4b-67d6cff3ef68.jpg,Airplane,456,514,1476,1536,58,60
2604,2560,2560,JPEG,RGB,False,1,980b5831-43b7-4adb-9e4b-67d6cff3ef68.jpg,Airplane,425,494,1576,1642,69,66
2605,2560,2560,JPEG,RGB,False,1,980b5831-43b7-4adb-9e4b-67d6cff3ef68.jpg,Airplane,1854,1949,407,507,95,100
2606,2560,2560,JPEG,RGB,False,1,980b5831-43b7-4adb-9e4b-67d6cff3ef68.jpg,Airplane,1775,1854,432,513,79,81
2607,2560,2560,JPEG,RGB,False,1,980b5831-43b7-4adb-9e4b-67d6cff3ef68.jpg,Airplane,2044,2121,446,543,77,97
2608,2560,2560,JPEG,RGB,False,1,980b5831-43b7-4adb-9e4b-67d6cff3ef68.jpg,Airplane,2119,2204,509,596,85,87
2609,2560,2560,JPEG,RGB,False,1,980b5831-43b7-4adb-9e4b-67d6cff3ef68.jpg,Airplane,2268,2350,709,799,82,90
2610,2560,2560,JPEG,RGB,False,1,980b5831-43b7-4adb-9e4b-67d6cff3ef68.jpg,Airplane,2339,2425,1070,1146,86,76
2611,2560,2560,JPEG,RGB,False,1,980b5831-43b7-4adb-9e4b-67d6cff3ef68.jpg,Airplane,2231,2331,1439,1527,100,88
2612,2560,2560,JPEG,RGB,False,1,980b5831-43b7-4adb-9e4b-67d6cff3ef68.jpg,Airplane,2168,2266,1721,1801,98,80
2613,2560,2560,JPEG,RGB,False,1,980b5831-43b7-4adb-9e4b-67d6cff3ef68.jpg,Airplane,1798,1892,1836,1913,94,77
2614,2560,2560,JPEG,RGB,False,1,980b5831-43b7-4adb-9e4b-67d6cff3ef68.jpg,Airplane,954,1036,1793,1855,82,62
2615,2560,2560,JPEG,RGB,False,1,980b5831-43b7-4adb-9e4b-67d6cff3ef68.jpg,Airplane,942,1012,1851,1914,70,63
2616,2560,2560,JPEG,RGB,False,1,980b5831-43b7-4adb-9e4b-67d6cff3ef68.jpg,Airplane,262,338,1794,1852,76,58
2617,2560,2560,JPEG,RGB,False,1,980b5831-43b7-4adb-9e4b-67d6cff3ef68.jpg,Airplane,1,40,1918,2005,39,87
2618,2560,2560,JPEG,RGB,False,1,980b5831-43b7-4adb-9e4b-67d6cff3ef68.jpg,Airplane,1720,1824,1931,2054,104,123
2619,2560,2560,JPEG,RGB,False,1,980b5831-43b7-4adb-9e4b-67d6cff3ef68.jpg,Airplane,1630,1708,1954,2054,78,100
2620,2560,2560,JPEG,RGB,False,1,980b5831-43b7-4adb-9e4b-67d6cff3ef68.jpg,Airplane,2458,2551,1572,1662,93,90
2621,2560,2560,JPEG,RGB,False,1,980b5831-43b7-4adb-9e4b-67d6cff3ef68.jpg,Airplane,2017,2092,1993,2090,75,97
2622,2560,2560,JPEG,RGB,False,1,980b5831-43b7-4adb-9e4b-67d6cff3ef68.jpg,Airplane,2369,2459,2031,2124,90,93
2623,2560,2560,JPEG,RGB,False,1,980b5831-43b7-4adb-9e4b-67d6cff3ef68.jpg,Airplane,2425,2512,2097,2175,87,78
2624,2560,2560,JPEG,RGB,False,1,980b5831-43b7-4adb-9e4b-67d6cff3ef68.jpg,Airplane,2240,2329,2230,2317,89,87
2625,2560,2560,JPEG,RGB,False,1,980b5831-43b7-4adb-9e4b-67d6cff3ef68.jpg,Airplane,903,984,2050,2157,81,107
2626,2560,2560,JPEG,RGB,False,1,980b5831-43b7-4adb-9e4b-67d6cff3ef68.jpg,Airplane,614,699,2062,2164,85,102
2627,2560,2560,JPEG,RGB,False,1,980b5831-43b7-4adb-9e4b-67d6cff3ef68.jpg,Airplane,518,592,2070,2161,74,91
2628,2560,2560,JPEG,RGB,False,1,980b5831-43b7-4adb-9e4b-67d6cff3ef68.jpg,Airplane,302,394,2049,2139,92,90
2629,2560,2560,JPEG,RGB,False,1,980b5831-43b7-4adb-9e4b-67d6cff3ef68.jpg,Airplane,303,420,2189,2289,117,100
2630,2560,2560,JPEG,RGB,False,1,980b5831-43b7-4adb-9e4b-67d6cff3ef68.jpg,Airplane,283,433,2293,2431,150,138
2631,2560,2560,JPEG,RGB,False,1,980b5831-43b7-4adb-9e4b-67d6cff3ef68.jpg,Airplane,268,444,2432,2557,176,125
2632,2560,2560,JPEG,RGB,False,1,980b5831-43b7-4adb-9e4b-67d6cff3ef68.jpg,Airplane,1713,1794,1720,1815,81,95
2633,2560,2560,JPEG,RGB,False,1,980b5831-43b7-4adb-9e4b-67d6cff3ef68.jpg,Truncated_airplane,2499,2567,983,1069,68,86
2634,2560,2560,JPEG,RGB,False,1,3e321b8a-9504-45aa-82b4-16158e28e290.jpg,Airplane,977,1131,240,375,154,135
2635,2560,2560,JPEG,RGB,False,1,3e321b8a-9504-45aa-82b4-16158e28e290.jpg,Airplane,877,932,380,429,55,49
2636,2560,2560,JPEG,RGB,False,1,3e321b8a-9504-45aa-82b4-16158e28e290.jpg,Airplane,2276,2416,351,479,140,128
2637,2560,2560,JPEG,RGB,False,1,3e321b8a-9504-45aa-82b4-16158e28e290.jpg,Airplane,1570,1641,901,984,71,83
2638,2560,2560,JPEG,RGB,False,1,3e321b8a-9504-45aa-82b4-16158e28e290.jpg,Airplane,982,1089,676,804,107,128
2639,2560,2560,JPEG,RGB,False,1,3e321b8a-9504-45aa-82b4-16158e28e290.jpg,Airplane,549,670,493,644,121,151
2640,2560,2560,JPEG,RGB,False,1,3e321b8a-9504-45aa-82b4-16158e28e290.jpg,Airplane,314,392,442,537,78,95
2641,2560,2560,JPEG,RGB,False,1,3e321b8a-9504-45aa-82b4-16158e28e290.jpg,Airplane,461,541,544,666,80,122
2642,2560,2560,JPEG,RGB,False,1,3e321b8a-9504-45aa-82b4-16158e28e290.jpg,Airplane,423,526,732,814,103,82
2643,2560,2560,JPEG,RGB,False,1,3e321b8a-9504-45aa-82b4-16158e28e290.jpg,Airplane,551,629,798,897,78,99
2644,2560,2560,JPEG,RGB,False,1,3e321b8a-9504-45aa-82b4-16158e28e290.jpg,Airplane,659,740,852,947,81,95
2645,2560,2560,JPEG,RGB,False,1,3e321b8a-9504-45aa-82b4-16158e28e290.jpg,Airplane,744,812,608,663,68,55
2646,2560,2560,JPEG,RGB,False,1,3e321b8a-9504-45aa-82b4-16158e28e290.jpg,Airplane,686,735,561,619,49,58
2647,2560,2560,JPEG,RGB,False,1,3e321b8a-9504-45aa-82b4-16158e28e290.jpg,Airplane,853,931,633,740,78,107
2648,2560,2560,JPEG,RGB,False,1,3e321b8a-9504-45aa-82b4-16158e28e290.jpg,Airplane,1128,1185,663,732,57,69
2649,2560,2560,JPEG,RGB,False,1,3e321b8a-9504-45aa-82b4-16158e28e290.jpg,Airplane,1243,1288,737,789,45,52
2650,2560,2560,JPEG,RGB,False,1,3e321b8a-9504-45aa-82b4-16158e28e290.jpg,Airplane,1225,1285,797,850,60,53
2651,2560,2560,JPEG,RGB,False,1,3e321b8a-9504-45aa-82b4-16158e28e290.jpg,Airplane,1190,1239,865,915,49,50
2652,2560,2560,JPEG,RGB,False,1,3e321b8a-9504-45aa-82b4-16158e28e290.jpg,Airplane,1678,1757,952,1033,79,81
2653,2560,2560,JPEG,RGB,False,1,3e321b8a-9504-45aa-82b4-16158e28e290.jpg,Airplane,1764,1863,1003,1072,99,69
2654,2560,2560,JPEG,RGB,False,1,3e321b8a-9504-45aa-82b4-16158e28e290.jpg,Airplane,1444,1515,1175,1254,71,79
2655,2560,2560,JPEG,RGB,False,1,3e321b8a-9504-45aa-82b4-16158e28e290.jpg,Airplane,1764,1856,1100,1175,92,75
2656,2560,2560,JPEG,RGB,False,1,3e321b8a-9504-45aa-82b4-16158e28e290.jpg,Airplane,1720,1800,1184,1255,80,71
2657,2560,2560,JPEG,RGB,False,1,3e321b8a-9504-45aa-82b4-16158e28e290.jpg,Airplane,1680,1766,1280,1349,86,69
2658,2560,2560,JPEG,RGB,False,1,3e321b8a-9504-45aa-82b4-16158e28e290.jpg,Airplane,835,907,1380,1459,72,79
2659,2560,2560,JPEG,RGB,False,1,3e321b8a-9504-45aa-82b4-16158e28e290.jpg,Airplane,771,837,1448,1530,66,82
2660,2560,2560,JPEG,RGB,False,1,3e321b8a-9504-45aa-82b4-16158e28e290.jpg,Airplane,618,743,1411,1545,125,134
2661,2560,2560,JPEG,RGB,False,1,3e321b8a-9504-45aa-82b4-16158e28e290.jpg,Airplane,477,609,1312,1480,132,168
2662,2560,2560,JPEG,RGB,False,1,3e321b8a-9504-45aa-82b4-16158e28e290.jpg,Airplane,213,334,1184,1332,121,148
2663,2560,2560,JPEG,RGB,False,1,3e321b8a-9504-45aa-82b4-16158e28e290.jpg,Airplane,70,199,1113,1265,129,152
2664,2560,2560,JPEG,RGB,False,1,3e321b8a-9504-45aa-82b4-16158e28e290.jpg,Airplane,197,311,1499,1621,114,122
2665,2560,2560,JPEG,RGB,False,1,3e321b8a-9504-45aa-82b4-16158e28e290.jpg,Airplane,340,447,1568,1708,107,140
2666,2560,2560,JPEG,RGB,False,1,3e321b8a-9504-45aa-82b4-16158e28e290.jpg,Airplane,41,131,1636,1703,90,67
2667,2560,2560,JPEG,RGB,False,1,3e321b8a-9504-45aa-82b4-16158e28e290.jpg,Airplane,2106,2169,1203,1292,63,89
2668,2560,2560,JPEG,RGB,False,1,3e321b8a-9504-45aa-82b4-16158e28e290.jpg,Airplane,2203,2278,1235,1323,75,88
2669,2560,2560,JPEG,RGB,False,1,3e321b8a-9504-45aa-82b4-16158e28e290.jpg,Airplane,2270,2355,1305,1388,85,83
2670,2560,2560,JPEG,RGB,False,1,3e321b8a-9504-45aa-82b4-16158e28e290.jpg,Airplane,2310,2393,1408,1477,83,69
2671,2560,2560,JPEG,RGB,False,1,3e321b8a-9504-45aa-82b4-16158e28e290.jpg,Airplane,2358,2446,1486,1567,88,81
2672,2560,2560,JPEG,RGB,False,1,3e321b8a-9504-45aa-82b4-16158e28e290.jpg,Airplane,2408,2477,1722,1806,69,84
2673,2560,2560,JPEG,RGB,False,1,3e321b8a-9504-45aa-82b4-16158e28e290.jpg,Airplane,2272,2345,1755,1836,73,81
2674,2560,2560,JPEG,RGB,False,1,3e321b8a-9504-45aa-82b4-16158e28e290.jpg,Airplane,2203,2291,1870,1941,88,71
2675,2560,2560,JPEG,RGB,False,1,3e321b8a-9504-45aa-82b4-16158e28e290.jpg,Airplane,2179,2251,1725,1804,72,79
2676,2560,2560,JPEG,RGB,False,1,3e321b8a-9504-45aa-82b4-16158e28e290.jpg,Airplane,1831,1904,1900,1983,73,83
2677,2560,2560,JPEG,RGB,False,1,3e321b8a-9504-45aa-82b4-16158e28e290.jpg,Airplane,1925,2000,1950,2028,75,78
2678,2560,2560,JPEG,RGB,False,1,3e321b8a-9504-45aa-82b4-16158e28e290.jpg,Airplane,2015,2097,1991,2078,82,87
2679,2560,2560,JPEG,RGB,False,1,3e321b8a-9504-45aa-82b4-16158e28e290.jpg,Airplane,2079,2134,2212,2275,55,63
2680,2560,2560,JPEG,RGB,False,1,3e321b8a-9504-45aa-82b4-16158e28e290.jpg,Airplane,1992,2056,2274,2349,64,75
2681,2560,2560,JPEG,RGB,False,1,3e321b8a-9504-45aa-82b4-16158e28e290.jpg,Airplane,1901,1970,2236,2316,69,80
2682,2560,2560,JPEG,RGB,False,1,3e321b8a-9504-45aa-82b4-16158e28e290.jpg,Airplane,1807,1893,2170,2279,86,109
2683,2560,2560,JPEG,RGB,False,1,3e321b8a-9504-45aa-82b4-16158e28e290.jpg,Truncated_airplane,1813,1894,2502,2556,81,54
2684,2560,2560,JPEG,RGB,False,1,3e321b8a-9504-45aa-82b4-16158e28e290.jpg,Airplane,1744,1803,2472,2555,59,83
2685,2560,2560,JPEG,RGB,False,1,3e321b8a-9504-45aa-82b4-16158e28e290.jpg,Airplane,1018,1150,2304,2446,132,142
2686,2560,2560,JPEG,RGB,False,1,3e321b8a-9504-45aa-82b4-16158e28e290.jpg,Airplane,858,1007,2455,2557,149,102
2687,2560,2560,JPEG,RGB,False,1,3e321b8a-9504-45aa-82b4-16158e28e290.jpg,Airplane,575,660,2490,2555,85,65
2688,2560,2560,JPEG,RGB,False,1,3e321b8a-9504-45aa-82b4-16158e28e290.jpg,Truncated_airplane,0,60,1038,1182,60,144
2689,2560,2560,JPEG,RGB,False,1,3e321b8a-9504-45aa-82b4-16158e28e290.jpg,Truncated_airplane,1,46,1337,1481,45,144
2690,2560,2560,JPEG,RGB,False,1,3e321b8a-9504-45aa-82b4-16158e28e290.jpg,Truncated_airplane,141,305,2457,2555,164,98
2691,2560,2560,JPEG,RGB,False,1,bfc53eb0-eb57-4dd7-8c1e-8e42ba49757b.jpg,Airplane,2309,2351,2125,2191,42,66
2692,2560,2560,JPEG,RGB,False,1,bfc53eb0-eb57-4dd7-8c1e-8e42ba49757b.jpg,Airplane,2459,2522,2022,2091,63,69
2693,2560,2560,JPEG,RGB,False,1,bfc53eb0-eb57-4dd7-8c1e-8e42ba49757b.jpg,Airplane,2228,2292,2022,2079,64,57
2694,2560,2560,JPEG,RGB,False,1,bfc53eb0-eb57-4dd7-8c1e-8e42ba49757b.jpg,Airplane,2063,2135,2216,2299,72,83
2695,2560,2560,JPEG,RGB,False,1,bfc53eb0-eb57-4dd7-8c1e-8e42ba49757b.jpg,Airplane,1920,1965,2315,2378,45,63
2696,2560,2560,JPEG,RGB,False,1,bfc53eb0-eb57-4dd7-8c1e-8e42ba49757b.jpg,Airplane,1835,1881,2335,2394,46,59
2697,2560,2560,JPEG,RGB,False,1,bfc53eb0-eb57-4dd7-8c1e-8e42ba49757b.jpg,Airplane,1614,1664,2345,2403,50,58
2698,2560,2560,JPEG,RGB,False,1,bfc53eb0-eb57-4dd7-8c1e-8e42ba49757b.jpg,Airplane,2281,2347,1861,1925,66,64
2699,2560,2560,JPEG,RGB,False,1,bfc53eb0-eb57-4dd7-8c1e-8e42ba49757b.jpg,Airplane,2302,2385,1775,1841,83,66
2700,2560,2560,JPEG,RGB,False,1,bfc53eb0-eb57-4dd7-8c1e-8e42ba49757b.jpg,Airplane,2288,2347,1370,1421,59,51
2701,2560,2560,JPEG,RGB,False,1,bfc53eb0-eb57-4dd7-8c1e-8e42ba49757b.jpg,Airplane,2303,2374,1458,1519,71,61
2702,2560,2560,JPEG,RGB,False,1,bfc53eb0-eb57-4dd7-8c1e-8e42ba49757b.jpg,Airplane,2467,2533,1220,1267,66,47
2703,2560,2560,JPEG,RGB,False,1,bfc53eb0-eb57-4dd7-8c1e-8e42ba49757b.jpg,Airplane,2414,2477,1147,1198,63,51
2704,2560,2560,JPEG,RGB,False,1,bfc53eb0-eb57-4dd7-8c1e-8e42ba49757b.jpg,Airplane,2322,2390,718,791,68,73
2705,2560,2560,JPEG,RGB,False,1,bfc53eb0-eb57-4dd7-8c1e-8e42ba49757b.jpg,Airplane,2329,2414,94,157,85,63
2706,2560,2560,JPEG,RGB,False,1,bfc53eb0-eb57-4dd7-8c1e-8e42ba49757b.jpg,Airplane,2363,2449,13,75,86,62
2707,2560,2560,JPEG,RGB,False,1,bfc53eb0-eb57-4dd7-8c1e-8e42ba49757b.jpg,Airplane,2381,2469,168,246,88,78
2708,2560,2560,JPEG,RGB,False,1,bfc53eb0-eb57-4dd7-8c1e-8e42ba49757b.jpg,Airplane,2309,2401,241,305,92,64
2709,2560,2560,JPEG,RGB,False,1,bfc53eb0-eb57-4dd7-8c1e-8e42ba49757b.jpg,Airplane,2257,2344,406,487,87,81
2710,2560,2560,JPEG,RGB,False,1,bfc53eb0-eb57-4dd7-8c1e-8e42ba49757b.jpg,Airplane,2156,2231,548,614,75,66
2711,2560,2560,JPEG,RGB,False,1,bfc53eb0-eb57-4dd7-8c1e-8e42ba49757b.jpg,Airplane,2089,2171,623,684,82,61
2712,2560,2560,JPEG,RGB,False,1,bfc53eb0-eb57-4dd7-8c1e-8e42ba49757b.jpg,Airplane,2048,2118,687,764,70,77
2713,2560,2560,JPEG,RGB,False,1,bfc53eb0-eb57-4dd7-8c1e-8e42ba49757b.jpg,Airplane,1968,2032,697,769,64,72
2714,2560,2560,JPEG,RGB,False,1,bfc53eb0-eb57-4dd7-8c1e-8e42ba49757b.jpg,Airplane,1885,1943,705,787,58,82
2715,2560,2560,JPEG,RGB,False,1,bfc53eb0-eb57-4dd7-8c1e-8e42ba49757b.jpg,Airplane,1798,1861,715,780,63,65
2716,2560,2560,JPEG,RGB,False,1,bfc53eb0-eb57-4dd7-8c1e-8e42ba49757b.jpg,Airplane,1703,1778,766,849,75,83
2717,2560,2560,JPEG,RGB,False,1,bfc53eb0-eb57-4dd7-8c1e-8e42ba49757b.jpg,Airplane,1626,1699,717,792,73,75
2718,2560,2560,JPEG,RGB,False,1,bfc53eb0-eb57-4dd7-8c1e-8e42ba49757b.jpg,Airplane,1028,1090,591,659,62,68
2719,2560,2560,JPEG,RGB,False,1,bfc53eb0-eb57-4dd7-8c1e-8e42ba49757b.jpg,Airplane,807,938,570,727,131,157
2720,2560,2560,JPEG,RGB,False,1,bfc53eb0-eb57-4dd7-8c1e-8e42ba49757b.jpg,Airplane,715,775,610,679,60,69
2721,2560,2560,JPEG,RGB,False,1,bfc53eb0-eb57-4dd7-8c1e-8e42ba49757b.jpg,Airplane,305,406,437,518,101,81
2722,2560,2560,JPEG,RGB,False,1,bfc53eb0-eb57-4dd7-8c1e-8e42ba49757b.jpg,Airplane,318,395,355,418,77,63
2723,2560,2560,JPEG,RGB,False,1,bfc53eb0-eb57-4dd7-8c1e-8e42ba49757b.jpg,Airplane,322,413,260,333,91,73
2724,2560,2560,JPEG,RGB,False,1,bfc53eb0-eb57-4dd7-8c1e-8e42ba49757b.jpg,Airplane,143,209,251,324,66,73
2725,2560,2560,JPEG,RGB,False,1,bfc53eb0-eb57-4dd7-8c1e-8e42ba49757b.jpg,Airplane,313,410,41,113,97,72
2726,2560,2560,JPEG,RGB,False,1,4e9164aa-532e-4b76-bce4-060b090da357.jpg,Truncated_airplane,1556,1695,1,67,139,66
2727,2560,2560,JPEG,RGB,False,1,4e9164aa-532e-4b76-bce4-060b090da357.jpg,Airplane,1720,1862,21,181,142,160
2728,2560,2560,JPEG,RGB,False,1,4e9164aa-532e-4b76-bce4-060b090da357.jpg,Airplane,1867,2011,176,330,144,154
2729,2560,2560,JPEG,RGB,False,1,4e9164aa-532e-4b76-bce4-060b090da357.jpg,Airplane,2039,2176,282,433,137,151
2730,2560,2560,JPEG,RGB,False,1,4e9164aa-532e-4b76-bce4-060b090da357.jpg,Airplane,2223,2362,383,532,139,149
2731,2560,2560,JPEG,RGB,False,1,4e9164aa-532e-4b76-bce4-060b090da357.jpg,Airplane,1976,2110,455,581,134,126
2732,2560,2560,JPEG,RGB,False,1,4e9164aa-532e-4b76-bce4-060b090da357.jpg,Airplane,2102,2169,823,907,67,84
2733,2560,2560,JPEG,RGB,False,1,4e9164aa-532e-4b76-bce4-060b090da357.jpg,Airplane,2113,2264,1165,1304,151,139
2734,2560,2560,JPEG,RGB,False,1,4e9164aa-532e-4b76-bce4-060b090da357.jpg,Airplane,1756,1887,1276,1430,131,154
2735,2560,2560,JPEG,RGB,False,1,4e9164aa-532e-4b76-bce4-060b090da357.jpg,Airplane,1482,1624,1205,1328,142,123
2736,2560,2560,JPEG,RGB,False,1,4e9164aa-532e-4b76-bce4-060b090da357.jpg,Airplane,1179,1319,1015,1139,140,124
2737,2560,2560,JPEG,RGB,False,1,4e9164aa-532e-4b76-bce4-060b090da357.jpg,Airplane,496,644,1635,1774,148,139
2738,2560,2560,JPEG,RGB,False,1,4e9164aa-532e-4b76-bce4-060b090da357.jpg,Airplane,1576,1704,2306,2453,128,147
2739,2560,2560,JPEG,RGB,False,1,4e9164aa-532e-4b76-bce4-060b090da357.jpg,Airplane,1034,1183,2419,2542,149,123
2740,2560,2560,JPEG,RGB,False,1,4e9164aa-532e-4b76-bce4-060b090da357.jpg,Airplane,812,956,2034,2181,144,147
2741,2560,2560,JPEG,RGB,False,1,4e9164aa-532e-4b76-bce4-060b090da357.jpg,Airplane,142,289,2112,2253,147,141
2742,2560,2560,JPEG,RGB,False,1,70332141-fcd3-4e2e-89c7-d50cbc03c25f.jpg,Airplane,2062,2107,2370,2444,45,74
2743,2560,2560,JPEG,RGB,False,1,70332141-fcd3-4e2e-89c7-d50cbc03c25f.jpg,Airplane,1982,2053,2484,2542,71,58
2744,2560,2560,JPEG,RGB,False,1,70332141-fcd3-4e2e-89c7-d50cbc03c25f.jpg,Airplane,2061,2138,2212,2295,77,83
2745,2560,2560,JPEG,RGB,False,1,70332141-fcd3-4e2e-89c7-d50cbc03c25f.jpg,Airplane,1914,1970,2312,2380,56,68
2746,2560,2560,JPEG,RGB,False,1,70332141-fcd3-4e2e-89c7-d50cbc03c25f.jpg,Airplane,1828,1889,2332,2400,61,68
2747,2560,2560,JPEG,RGB,False,1,70332141-fcd3-4e2e-89c7-d50cbc03c25f.jpg,Airplane,1748,1799,2337,2406,51,69
2748,2560,2560,JPEG,RGB,False,1,70332141-fcd3-4e2e-89c7-d50cbc03c25f.jpg,Airplane,2187,2246,2093,2166,59,73
2749,2560,2560,JPEG,RGB,False,1,70332141-fcd3-4e2e-89c7-d50cbc03c25f.jpg,Airplane,2229,2306,2021,2093,77,72
2750,2560,2560,JPEG,RGB,False,1,70332141-fcd3-4e2e-89c7-d50cbc03c25f.jpg,Airplane,2300,2382,1773,1846,82,73
2751,2560,2560,JPEG,RGB,False,1,70332141-fcd3-4e2e-89c7-d50cbc03c25f.jpg,Airplane,2308,2372,1673,1721,64,48
2752,2560,2560,JPEG,RGB,False,1,70332141-fcd3-4e2e-89c7-d50cbc03c25f.jpg,Airplane,2280,2352,1364,1422,72,58
2753,2560,2560,JPEG,RGB,False,1,70332141-fcd3-4e2e-89c7-d50cbc03c25f.jpg,Airplane,2237,2301,1296,1352,64,56
2754,2560,2560,JPEG,RGB,False,1,70332141-fcd3-4e2e-89c7-d50cbc03c25f.jpg,Airplane,1770,1841,1008,1085,71,77
2755,2560,2560,JPEG,RGB,False,1,70332141-fcd3-4e2e-89c7-d50cbc03c25f.jpg,Airplane,2410,2503,601,677,93,76
2756,2560,2560,JPEG,RGB,False,1,70332141-fcd3-4e2e-89c7-d50cbc03c25f.jpg,Airplane,2236,2305,494,553,69,59
2757,2560,2560,JPEG,RGB,False,1,70332141-fcd3-4e2e-89c7-d50cbc03c25f.jpg,Airplane,2151,2230,549,609,79,60
2758,2560,2560,JPEG,RGB,False,1,70332141-fcd3-4e2e-89c7-d50cbc03c25f.jpg,Airplane,2048,2112,690,757,64,67
2759,2560,2560,JPEG,RGB,False,1,70332141-fcd3-4e2e-89c7-d50cbc03c25f.jpg,Airplane,1961,2032,684,761,71,77
2760,2560,2560,JPEG,RGB,False,1,70332141-fcd3-4e2e-89c7-d50cbc03c25f.jpg,Airplane,1872,1948,701,784,76,83
2761,2560,2560,JPEG,RGB,False,1,70332141-fcd3-4e2e-89c7-d50cbc03c25f.jpg,Airplane,2262,2349,417,478,87,61
2762,2560,2560,JPEG,RGB,False,1,70332141-fcd3-4e2e-89c7-d50cbc03c25f.jpg,Airplane,2326,2410,337,393,84,56
2763,2560,2560,JPEG,RGB,False,1,70332141-fcd3-4e2e-89c7-d50cbc03c25f.jpg,Airplane,2314,2404,237,311,90,74
2764,2560,2560,JPEG,RGB,False,1,70332141-fcd3-4e2e-89c7-d50cbc03c25f.jpg,Airplane,2322,2410,94,159,88,65
2765,2560,2560,JPEG,RGB,False,1,70332141-fcd3-4e2e-89c7-d50cbc03c25f.jpg,Airplane,2361,2448,14,74,87,60
2766,2560,2560,JPEG,RGB,False,1,70332141-fcd3-4e2e-89c7-d50cbc03c25f.jpg,Airplane,1707,1786,707,792,79,85
2767,2560,2560,JPEG,RGB,False,1,70332141-fcd3-4e2e-89c7-d50cbc03c25f.jpg,Airplane,1676,1724,2340,2408,48,68
2768,2560,2560,JPEG,RGB,False,1,70332141-fcd3-4e2e-89c7-d50cbc03c25f.jpg,Airplane,1618,1660,2336,2403,42,67
2769,2560,2560,JPEG,RGB,False,1,70332141-fcd3-4e2e-89c7-d50cbc03c25f.jpg,Airplane,540,594,619,688,54,69
2770,2560,2560,JPEG,RGB,False,1,70332141-fcd3-4e2e-89c7-d50cbc03c25f.jpg,Airplane,824,889,923,1005,65,82
2771,2560,2560,JPEG,RGB,False,1,70332141-fcd3-4e2e-89c7-d50cbc03c25f.jpg,Airplane,1029,1082,587,657,53,70
2772,2560,2560,JPEG,RGB,False,1,70332141-fcd3-4e2e-89c7-d50cbc03c25f.jpg,Airplane,809,946,579,727,137,148
2773,2560,2560,JPEG,RGB,False,1,70332141-fcd3-4e2e-89c7-d50cbc03c25f.jpg,Airplane,306,398,160,233,92,73
2774,2560,2560,JPEG,RGB,False,1,ac77b86a-4198-4d40-900e-a95e520b2ac7.jpg,Airplane,146,305,658,804,159,146
2775,2560,2560,JPEG,RGB,False,1,ac77b86a-4198-4d40-900e-a95e520b2ac7.jpg,Airplane,541,623,675,753,82,78
2776,2560,2560,JPEG,RGB,False,1,ac77b86a-4198-4d40-900e-a95e520b2ac7.jpg,Airplane,448,598,790,923,150,133
2777,2560,2560,JPEG,RGB,False,1,ac77b86a-4198-4d40-900e-a95e520b2ac7.jpg,Airplane,397,528,930,1059,131,129
2778,2560,2560,JPEG,RGB,False,1,ac77b86a-4198-4d40-900e-a95e520b2ac7.jpg,Airplane,399,480,1094,1170,81,76
2779,2560,2560,JPEG,RGB,False,1,ac77b86a-4198-4d40-900e-a95e520b2ac7.jpg,Airplane,641,797,1078,1209,156,131
2780,2560,2560,JPEG,RGB,False,1,ac77b86a-4198-4d40-900e-a95e520b2ac7.jpg,Airplane,791,945,795,918,154,123
2781,2560,2560,JPEG,RGB,False,1,ac77b86a-4198-4d40-900e-a95e520b2ac7.jpg,Airplane,860,1011,660,783,151,123
2782,2560,2560,JPEG,RGB,False,1,ac77b86a-4198-4d40-900e-a95e520b2ac7.jpg,Airplane,1003,1078,583,679,75,96
2783,2560,2560,JPEG,RGB,False,1,ac77b86a-4198-4d40-900e-a95e520b2ac7.jpg,Airplane,1022,1149,789,960,127,171
2784,2560,2560,JPEG,RGB,False,1,ac77b86a-4198-4d40-900e-a95e520b2ac7.jpg,Airplane,1281,1356,808,886,75,78
2785,2560,2560,JPEG,RGB,False,1,ac77b86a-4198-4d40-900e-a95e520b2ac7.jpg,Airplane,1243,1302,1012,1086,59,74
2786,2560,2560,JPEG,RGB,False,1,ac77b86a-4198-4d40-900e-a95e520b2ac7.jpg,Airplane,1320,1393,1051,1117,73,66
2787,2560,2560,JPEG,RGB,False,1,ac77b86a-4198-4d40-900e-a95e520b2ac7.jpg,Airplane,1066,1142,1172,1239,76,67
2788,2560,2560,JPEG,RGB,False,1,ac77b86a-4198-4d40-900e-a95e520b2ac7.jpg,Airplane,1701,1782,1363,1462,81,99
2789,2560,2560,JPEG,RGB,False,1,ac77b86a-4198-4d40-900e-a95e520b2ac7.jpg,Airplane,2001,2124,2194,2306,123,112
2790,2560,2560,JPEG,RGB,False,1,ac77b86a-4198-4d40-900e-a95e520b2ac7.jpg,Airplane,2266,2361,2194,2318,95,124
2791,2560,2560,JPEG,RGB,False,1,ac77b86a-4198-4d40-900e-a95e520b2ac7.jpg,Airplane,1786,1851,2441,2520,65,79
2792,2560,2560,JPEG,RGB,False,1,ac77b86a-4198-4d40-900e-a95e520b2ac7.jpg,Airplane,2109,2165,630,705,56,75
2793,2560,2560,JPEG,RGB,False,1,ac77b86a-4198-4d40-900e-a95e520b2ac7.jpg,Airplane,2209,2268,779,850,59,71
2794,2560,2560,JPEG,RGB,False,1,ac77b86a-4198-4d40-900e-a95e520b2ac7.jpg,Airplane,2087,2153,1006,1072,66,66
2795,2560,2560,JPEG,RGB,False,1,ac77b86a-4198-4d40-900e-a95e520b2ac7.jpg,Airplane,1827,1889,401,472,62,71
2796,2560,2560,JPEG,RGB,False,1,ac77b86a-4198-4d40-900e-a95e520b2ac7.jpg,Airplane,2095,2186,344,424,91,80
2797,2560,2560,JPEG,RGB,False,1,ac77b86a-4198-4d40-900e-a95e520b2ac7.jpg,Airplane,2137,2231,153,233,94,80
2798,2560,2560,JPEG,RGB,False,1,ac77b86a-4198-4d40-900e-a95e520b2ac7.jpg,Airplane,1832,1892,118,180,60,62
2799,2560,2560,JPEG,RGB,False,1,ac77b86a-4198-4d40-900e-a95e520b2ac7.jpg,Truncated_airplane,2277,2354,0,46,77,46
2800,2560,2560,JPEG,RGB,False,1,ac77b86a-4198-4d40-900e-a95e520b2ac7.jpg,Airplane,1368,1455,661,732,87,71
2801,2560,2560,JPEG,RGB,False,1,ad36e699-4a1f-4891-b579-6e9ac3e54235.jpg,Truncated_airplane,712,807,0,49,95,49
2802,2560,2560,JPEG,RGB,False,1,ad36e699-4a1f-4891-b579-6e9ac3e54235.jpg,Truncated_airplane,889,997,2,52,108,50
2803,2560,2560,JPEG,RGB,False,1,ad36e699-4a1f-4891-b579-6e9ac3e54235.jpg,Truncated_airplane,1185,1282,1,48,97,47
2804,2560,2560,JPEG,RGB,False,1,ad36e699-4a1f-4891-b579-6e9ac3e54235.jpg,Truncated_airplane,2162,2220,0,42,58,42
2805,2560,2560,JPEG,RGB,False,1,ad36e699-4a1f-4891-b579-6e9ac3e54235.jpg,Truncated_airplane,2253,2301,0,41,48,41
2806,2560,2560,JPEG,RGB,False,1,ad36e699-4a1f-4891-b579-6e9ac3e54235.jpg,Truncated_airplane,2338,2398,0,31,60,31
2807,2560,2560,JPEG,RGB,False,1,ad36e699-4a1f-4891-b579-6e9ac3e54235.jpg,Airplane,696,789,416,495,93,79
2808,2560,2560,JPEG,RGB,False,1,ad36e699-4a1f-4891-b579-6e9ac3e54235.jpg,Airplane,889,983,399,493,94,94
2809,2560,2560,JPEG,RGB,False,1,ad36e699-4a1f-4891-b579-6e9ac3e54235.jpg,Airplane,1098,1192,406,496,94,90
2810,2560,2560,JPEG,RGB,False,1,ad36e699-4a1f-4891-b579-6e9ac3e54235.jpg,Airplane,1196,1282,406,490,86,84
2811,2560,2560,JPEG,RGB,False,1,ad36e699-4a1f-4891-b579-6e9ac3e54235.jpg,Airplane,1293,1374,403,495,81,92
2812,2560,2560,JPEG,RGB,False,1,ad36e699-4a1f-4891-b579-6e9ac3e54235.jpg,Airplane,1598,1681,404,496,83,92
2813,2560,2560,JPEG,RGB,False,1,ad36e699-4a1f-4891-b579-6e9ac3e54235.jpg,Airplane,1688,1775,410,497,87,87
2814,2560,2560,JPEG,RGB,False,1,ad36e699-4a1f-4891-b579-6e9ac3e54235.jpg,Airplane,1777,1861,402,496,84,94
2815,2560,2560,JPEG,RGB,False,1,ad36e699-4a1f-4891-b579-6e9ac3e54235.jpg,Airplane,1985,2062,411,497,77,86
2816,2560,2560,JPEG,RGB,False,1,ad36e699-4a1f-4891-b579-6e9ac3e54235.jpg,Airplane,2095,2170,421,507,75,86
2817,2560,2560,JPEG,RGB,False,1,ad36e699-4a1f-4891-b579-6e9ac3e54235.jpg,Airplane,2101,2182,672,769,81,97
2818,2560,2560,JPEG,RGB,False,1,ad36e699-4a1f-4891-b579-6e9ac3e54235.jpg,Airplane,2011,2094,680,761,83,81
2819,2560,2560,JPEG,RGB,False,1,ad36e699-4a1f-4891-b579-6e9ac3e54235.jpg,Airplane,1790,1869,667,758,79,91
2820,2560,2560,JPEG,RGB,False,1,ad36e699-4a1f-4891-b579-6e9ac3e54235.jpg,Airplane,1692,1774,670,758,82,88
2821,2560,2560,JPEG,RGB,False,1,ad36e699-4a1f-4891-b579-6e9ac3e54235.jpg,Airplane,1593,1681,709,789,88,80
2822,2560,2560,JPEG,RGB,False,1,ad36e699-4a1f-4891-b579-6e9ac3e54235.jpg,Airplane,1373,1461,714,804,88,90
2823,2560,2560,JPEG,RGB,False,1,ad36e699-4a1f-4891-b579-6e9ac3e54235.jpg,Airplane,1559,1658,964,1046,99,82
2824,2560,2560,JPEG,RGB,False,1,ad36e699-4a1f-4891-b579-6e9ac3e54235.jpg,Airplane,1188,1273,667,754,85,87
2825,2560,2560,JPEG,RGB,False,1,ad36e699-4a1f-4891-b579-6e9ac3e54235.jpg,Airplane,1101,1176,669,753,75,84
2826,2560,2560,JPEG,RGB,False,1,ad36e699-4a1f-4891-b579-6e9ac3e54235.jpg,Airplane,895,970,664,753,75,89
2827,2560,2560,JPEG,RGB,False,1,ad36e699-4a1f-4891-b579-6e9ac3e54235.jpg,Airplane,797,882,661,752,85,91
2828,2560,2560,JPEG,RGB,False,1,ad36e699-4a1f-4891-b579-6e9ac3e54235.jpg,Airplane,693,786,671,756,93,85
2829,2560,2560,JPEG,RGB,False,1,ad36e699-4a1f-4891-b579-6e9ac3e54235.jpg,Airplane,792,901,1244,1339,109,95
2830,2560,2560,JPEG,RGB,False,1,ad36e699-4a1f-4891-b579-6e9ac3e54235.jpg,Airplane,402,483,1429,1507,81,78
2831,2560,2560,JPEG,RGB,False,1,ad36e699-4a1f-4891-b579-6e9ac3e54235.jpg,Airplane,594,687,1431,1514,93,83
2832,2560,2560,JPEG,RGB,False,1,ad36e699-4a1f-4891-b579-6e9ac3e54235.jpg,Airplane,1191,1272,1426,1515,81,89
2833,2560,2560,JPEG,RGB,False,1,ad36e699-4a1f-4891-b579-6e9ac3e54235.jpg,Airplane,1325,1418,1416,1508,93,92
2834,2560,2560,JPEG,RGB,False,1,ad36e699-4a1f-4891-b579-6e9ac3e54235.jpg,Airplane,1703,1789,1426,1520,86,94
2835,2560,2560,JPEG,RGB,False,1,ad36e699-4a1f-4891-b579-6e9ac3e54235.jpg,Airplane,1919,2001,1428,1520,82,92
2836,2560,2560,JPEG,RGB,False,1,ad36e699-4a1f-4891-b579-6e9ac3e54235.jpg,Airplane,2254,2318,1441,1523,64,82
2837,2560,2560,JPEG,RGB,False,1,ad36e699-4a1f-4891-b579-6e9ac3e54235.jpg,Airplane,2192,2257,1774,1848,65,74
2838,2560,2560,JPEG,RGB,False,1,ad36e699-4a1f-4891-b579-6e9ac3e54235.jpg,Airplane,2485,2551,1786,1864,66,78
2839,2560,2560,JPEG,RGB,False,1,ad36e699-4a1f-4891-b579-6e9ac3e54235.jpg,Airplane,1899,1990,1764,1869,91,105
2840,2560,2560,JPEG,RGB,False,1,ad36e699-4a1f-4891-b579-6e9ac3e54235.jpg,Airplane,1783,1871,1749,1862,88,113
2841,2560,2560,JPEG,RGB,False,1,ad36e699-4a1f-4891-b579-6e9ac3e54235.jpg,Airplane,1124,1264,1732,1862,140,130
2842,2560,2560,JPEG,RGB,False,1,ad36e699-4a1f-4891-b579-6e9ac3e54235.jpg,Airplane,909,999,1761,1848,90,87
2843,2560,2560,JPEG,RGB,False,1,ad36e699-4a1f-4891-b579-6e9ac3e54235.jpg,Airplane,810,890,1762,1857,80,95
2844,2560,2560,JPEG,RGB,False,1,ad36e699-4a1f-4891-b579-6e9ac3e54235.jpg,Airplane,674,765,1755,1844,91,89
2845,2560,2560,JPEG,RGB,False,1,ad36e699-4a1f-4891-b579-6e9ac3e54235.jpg,Airplane,491,567,1768,1863,76,95
2846,2560,2560,JPEG,RGB,False,1,ad36e699-4a1f-4891-b579-6e9ac3e54235.jpg,Airplane,391,475,1762,1858,84,96
2847,2560,2560,JPEG,RGB,False,1,4fdabd34-a2fd-4f0a-bb48-01fe043f1499.jpg,Truncated_airplane,2526,2560,642,723,34,81
2848,2560,2560,JPEG,RGB,False,1,4fdabd34-a2fd-4f0a-bb48-01fe043f1499.jpg,Airplane,1857,1927,419,499,70,80
2849,2560,2560,JPEG,RGB,False,1,4fdabd34-a2fd-4f0a-bb48-01fe043f1499.jpg,Airplane,1756,1840,404,500,84,96
2850,2560,2560,JPEG,RGB,False,1,4fdabd34-a2fd-4f0a-bb48-01fe043f1499.jpg,Airplane,1939,2027,670,764,88,94
2851,2560,2560,JPEG,RGB,False,1,4fdabd34-a2fd-4f0a-bb48-01fe043f1499.jpg,Airplane,1957,2039,871,965,82,94
2852,2560,2560,JPEG,RGB,False,1,4fdabd34-a2fd-4f0a-bb48-01fe043f1499.jpg,Airplane,1441,1546,492,589,105,97
2853,2560,2560,JPEG,RGB,False,1,4fdabd34-a2fd-4f0a-bb48-01fe043f1499.jpg,Airplane,1460,1551,626,709,91,83
2854,2560,2560,JPEG,RGB,False,1,4fdabd34-a2fd-4f0a-bb48-01fe043f1499.jpg,Airplane,1442,1547,723,815,105,92
2855,2560,2560,JPEG,RGB,False,1,4fdabd34-a2fd-4f0a-bb48-01fe043f1499.jpg,Airplane,1031,1119,441,563,88,122
2856,2560,2560,JPEG,RGB,False,1,4fdabd34-a2fd-4f0a-bb48-01fe043f1499.jpg,Airplane,1109,1200,536,631,91,95
2857,2560,2560,JPEG,RGB,False,1,4fdabd34-a2fd-4f0a-bb48-01fe043f1499.jpg,Airplane,1126,1239,641,727,113,86
2858,2560,2560,JPEG,RGB,False,1,4fdabd34-a2fd-4f0a-bb48-01fe043f1499.jpg,Airplane,1162,1266,738,816,104,78
2859,2560,2560,JPEG,RGB,False,1,4fdabd34-a2fd-4f0a-bb48-01fe043f1499.jpg,Airplane,890,979,463,558,89,95
2860,2560,2560,JPEG,RGB,False,1,4fdabd34-a2fd-4f0a-bb48-01fe043f1499.jpg,Airplane,698,791,494,616,93,122
2861,2560,2560,JPEG,RGB,False,1,4fdabd34-a2fd-4f0a-bb48-01fe043f1499.jpg,Airplane,604,710,663,760,106,97
2862,2560,2560,JPEG,RGB,False,1,4fdabd34-a2fd-4f0a-bb48-01fe043f1499.jpg,Airplane,497,593,794,890,96,96
2863,2560,2560,JPEG,RGB,False,1,4fdabd34-a2fd-4f0a-bb48-01fe043f1499.jpg,Airplane,661,770,875,964,109,89
2864,2560,2560,JPEG,RGB,False,1,4fdabd34-a2fd-4f0a-bb48-01fe043f1499.jpg,Airplane,680,786,980,1062,106,82
2865,2560,2560,JPEG,RGB,False,1,4fdabd34-a2fd-4f0a-bb48-01fe043f1499.jpg,Truncated_airplane,0,75,971,1072,75,101
2866,2560,2560,JPEG,RGB,False,1,4fdabd34-a2fd-4f0a-bb48-01fe043f1499.jpg,Airplane,2320,2423,1587,1683,103,96
2867,2560,2560,JPEG,RGB,False,1,4fdabd34-a2fd-4f0a-bb48-01fe043f1499.jpg,Airplane,2219,2374,1722,1863,155,141
2868,2560,2560,JPEG,RGB,False,1,4fdabd34-a2fd-4f0a-bb48-01fe043f1499.jpg,Airplane,2088,2167,1737,1838,79,101
2869,2560,2560,JPEG,RGB,False,1,4fdabd34-a2fd-4f0a-bb48-01fe043f1499.jpg,Airplane,1970,2061,1788,1894,91,106
2870,2560,2560,JPEG,RGB,False,1,4fdabd34-a2fd-4f0a-bb48-01fe043f1499.jpg,Airplane,1837,1925,1761,1853,88,92
2871,2560,2560,JPEG,RGB,False,1,4fdabd34-a2fd-4f0a-bb48-01fe043f1499.jpg,Airplane,2289,2394,2080,2215,105,135
2872,2560,2560,JPEG,RGB,False,1,4fdabd34-a2fd-4f0a-bb48-01fe043f1499.jpg,Airplane,2098,2257,2069,2225,159,156
2873,2560,2560,JPEG,RGB,False,1,4fdabd34-a2fd-4f0a-bb48-01fe043f1499.jpg,Airplane,1915,2077,2055,2248,162,193
2874,2560,2560,JPEG,RGB,False,1,4fdabd34-a2fd-4f0a-bb48-01fe043f1499.jpg,Airplane,1728,1883,2065,2224,155,159
2875,2560,2560,JPEG,RGB,False,1,4fdabd34-a2fd-4f0a-bb48-01fe043f1499.jpg,Airplane,1545,1708,2069,2265,163,196
2876,2560,2560,JPEG,RGB,False,1,4fdabd34-a2fd-4f0a-bb48-01fe043f1499.jpg,Airplane,1356,1527,2084,2281,171,197
2877,2560,2560,JPEG,RGB,False,1,4fdabd34-a2fd-4f0a-bb48-01fe043f1499.jpg,Airplane,1178,1335,2120,2292,157,172
2878,2560,2560,JPEG,RGB,False,1,4fdabd34-a2fd-4f0a-bb48-01fe043f1499.jpg,Airplane,994,1155,2144,2307,161,163
2879,2560,2560,JPEG,RGB,False,1,4fdabd34-a2fd-4f0a-bb48-01fe043f1499.jpg,Airplane,840,974,2173,2325,134,152
2880,2560,2560,JPEG,RGB,False,1,4fdabd34-a2fd-4f0a-bb48-01fe043f1499.jpg,Airplane,688,790,2199,2279,102,80
2881,2560,2560,JPEG,RGB,False,1,4fdabd34-a2fd-4f0a-bb48-01fe043f1499.jpg,Truncated_airplane,0,71,2164,2273,71,109
2882,2560,2560,JPEG,RGB,False,1,6627e7c7-2fdd-4f3c-965e-b4d73d0a4cc2.jpg,Truncated_airplane,0,70,682,748,70,66
2883,2560,2560,JPEG,RGB,False,1,6627e7c7-2fdd-4f3c-965e-b4d73d0a4cc2.jpg,Truncated_airplane,0,82,770,846,82,76
2884,2560,2560,JPEG,RGB,False,1,6627e7c7-2fdd-4f3c-965e-b4d73d0a4cc2.jpg,Truncated_airplane,0,70,1221,1295,70,74
2885,2560,2560,JPEG,RGB,False,1,6627e7c7-2fdd-4f3c-965e-b4d73d0a4cc2.jpg,Truncated_airplane,0,71,1357,1427,71,70
2886,2560,2560,JPEG,RGB,False,1,6627e7c7-2fdd-4f3c-965e-b4d73d0a4cc2.jpg,Truncated_airplane,0,72,1542,1613,72,71
2887,2560,2560,JPEG,RGB,False,1,6627e7c7-2fdd-4f3c-965e-b4d73d0a4cc2.jpg,Truncated_airplane,0,72,1811,1885,72,74
2888,2560,2560,JPEG,RGB,False,1,6627e7c7-2fdd-4f3c-965e-b4d73d0a4cc2.jpg,Truncated_airplane,0,61,1633,1705,61,72
2889,2560,2560,JPEG,RGB,False,1,6627e7c7-2fdd-4f3c-965e-b4d73d0a4cc2.jpg,Truncated_airplane,1,73,1994,2069,72,75
2890,2560,2560,JPEG,RGB,False,1,6627e7c7-2fdd-4f3c-965e-b4d73d0a4cc2.jpg,Airplane,108,207,605,672,99,67
2891,2560,2560,JPEG,RGB,False,1,6627e7c7-2fdd-4f3c-965e-b4d73d0a4cc2.jpg,Airplane,373,465,615,684,92,69
2892,2560,2560,JPEG,RGB,False,1,6627e7c7-2fdd-4f3c-965e-b4d73d0a4cc2.jpg,Airplane,601,693,686,752,92,66
2893,2560,2560,JPEG,RGB,False,1,6627e7c7-2fdd-4f3c-965e-b4d73d0a4cc2.jpg,Airplane,854,926,678,734,72,56
2894,2560,2560,JPEG,RGB,False,1,6627e7c7-2fdd-4f3c-965e-b4d73d0a4cc2.jpg,Airplane,599,687,936,995,88,59
2895,2560,2560,JPEG,RGB,False,1,6627e7c7-2fdd-4f3c-965e-b4d73d0a4cc2.jpg,Airplane,591,687,1088,1154,96,66
2896,2560,2560,JPEG,RGB,False,1,6627e7c7-2fdd-4f3c-965e-b4d73d0a4cc2.jpg,Airplane,362,454,1102,1177,92,75
2897,2560,2560,JPEG,RGB,False,1,6627e7c7-2fdd-4f3c-965e-b4d73d0a4cc2.jpg,Airplane,356,457,1403,1478,101,75
2898,2560,2560,JPEG,RGB,False,1,6627e7c7-2fdd-4f3c-965e-b4d73d0a4cc2.jpg,Airplane,367,460,1483,1562,93,79
2899,2560,2560,JPEG,RGB,False,1,6627e7c7-2fdd-4f3c-965e-b4d73d0a4cc2.jpg,Airplane,367,461,1574,1648,94,74
2900,2560,2560,JPEG,RGB,False,1,6627e7c7-2fdd-4f3c-965e-b4d73d0a4cc2.jpg,Airplane,1002,1075,1127,1176,73,49
2901,2560,2560,JPEG,RGB,False,1,6627e7c7-2fdd-4f3c-965e-b4d73d0a4cc2.jpg,Airplane,979,1057,748,802,78,54
2902,2560,2560,JPEG,RGB,False,1,6627e7c7-2fdd-4f3c-965e-b4d73d0a4cc2.jpg,Airplane,987,1053,813,862,66,49
2903,2560,2560,JPEG,RGB,False,1,6627e7c7-2fdd-4f3c-965e-b4d73d0a4cc2.jpg,Airplane,986,1051,874,925,65,51
2904,2560,2560,JPEG,RGB,False,1,6627e7c7-2fdd-4f3c-965e-b4d73d0a4cc2.jpg,Airplane,1073,1122,608,671,49,63
2905,2560,2560,JPEG,RGB,False,1,6627e7c7-2fdd-4f3c-965e-b4d73d0a4cc2.jpg,Airplane,1215,1278,657,713,63,56
2906,2560,2560,JPEG,RGB,False,1,6627e7c7-2fdd-4f3c-965e-b4d73d0a4cc2.jpg,Airplane,1208,1268,775,833,60,58
2907,2560,2560,JPEG,RGB,False,1,6627e7c7-2fdd-4f3c-965e-b4d73d0a4cc2.jpg,Airplane,1208,1268,891,942,60,51
2908,2560,2560,JPEG,RGB,False,1,6627e7c7-2fdd-4f3c-965e-b4d73d0a4cc2.jpg,Airplane,1328,1408,943,1039,80,96
2909,2560,2560,JPEG,RGB,False,1,6627e7c7-2fdd-4f3c-965e-b4d73d0a4cc2.jpg,Airplane,1213,1294,1300,1355,81,55
2910,2560,2560,JPEG,RGB,False,1,6627e7c7-2fdd-4f3c-965e-b4d73d0a4cc2.jpg,Airplane,1201,1280,1371,1430,79,59
2911,2560,2560,JPEG,RGB,False,1,6627e7c7-2fdd-4f3c-965e-b4d73d0a4cc2.jpg,Airplane,1213,1292,1457,1515,79,58
2912,2560,2560,JPEG,RGB,False,1,6627e7c7-2fdd-4f3c-965e-b4d73d0a4cc2.jpg,Airplane,996,1066,1520,1568,70,48
2913,2560,2560,JPEG,RGB,False,1,6627e7c7-2fdd-4f3c-965e-b4d73d0a4cc2.jpg,Airplane,1482,1533,1372,1448,51,76
2914,2560,2560,JPEG,RGB,False,1,6627e7c7-2fdd-4f3c-965e-b4d73d0a4cc2.jpg,Airplane,1624,1741,1416,1521,117,105
2915,2560,2560,JPEG,RGB,False,1,6627e7c7-2fdd-4f3c-965e-b4d73d0a4cc2.jpg,Airplane,1646,1737,785,858,91,73
2916,2560,2560,JPEG,RGB,False,1,6627e7c7-2fdd-4f3c-965e-b4d73d0a4cc2.jpg,Airplane,1616,1741,636,753,125,117
2917,2560,2560,JPEG,RGB,False,1,6627e7c7-2fdd-4f3c-965e-b4d73d0a4cc2.jpg,Airplane,1861,1962,782,857,101,75
2918,2560,2560,JPEG,RGB,False,1,6627e7c7-2fdd-4f3c-965e-b4d73d0a4cc2.jpg,Airplane,1609,1667,400,454,58,54
2919,2560,2560,JPEG,RGB,False,1,6627e7c7-2fdd-4f3c-965e-b4d73d0a4cc2.jpg,Airplane,2200,2237,674,721,37,47
2920,2560,2560,JPEG,RGB,False,1,6627e7c7-2fdd-4f3c-965e-b4d73d0a4cc2.jpg,Airplane,2090,2178,1168,1275,88,107
2921,2560,2560,JPEG,RGB,False,1,6627e7c7-2fdd-4f3c-965e-b4d73d0a4cc2.jpg,Airplane,2214,2292,1156,1265,78,109
2922,2560,2560,JPEG,RGB,False,1,6627e7c7-2fdd-4f3c-965e-b4d73d0a4cc2.jpg,Airplane,581,680,1658,1734,99,76
2923,2560,2560,JPEG,RGB,False,1,6627e7c7-2fdd-4f3c-965e-b4d73d0a4cc2.jpg,Airplane,364,465,1653,1727,101,74
2924,2560,2560,JPEG,RGB,False,1,6627e7c7-2fdd-4f3c-965e-b4d73d0a4cc2.jpg,Airplane,344,439,1738,1815,95,77
2925,2560,2560,JPEG,RGB,False,1,6627e7c7-2fdd-4f3c-965e-b4d73d0a4cc2.jpg,Airplane,368,473,1904,1990,105,86
2926,2560,2560,JPEG,RGB,False,1,6627e7c7-2fdd-4f3c-965e-b4d73d0a4cc2.jpg,Airplane,382,477,2001,2078,95,77
2927,2560,2560,JPEG,RGB,False,1,6627e7c7-2fdd-4f3c-965e-b4d73d0a4cc2.jpg,Airplane,862,920,1860,1944,58,84
2928,2560,2560,JPEG,RGB,False,1,6627e7c7-2fdd-4f3c-965e-b4d73d0a4cc2.jpg,Airplane,992,1062,1678,1733,70,55
2929,2560,2560,JPEG,RGB,False,1,6627e7c7-2fdd-4f3c-965e-b4d73d0a4cc2.jpg,Airplane,1196,1287,1702,1769,91,67
2930,2560,2560,JPEG,RGB,False,1,6627e7c7-2fdd-4f3c-965e-b4d73d0a4cc2.jpg,Airplane,1234,1318,1850,1925,84,75
2931,2560,2560,JPEG,RGB,False,1,6627e7c7-2fdd-4f3c-965e-b4d73d0a4cc2.jpg,Airplane,396,462,2295,2375,66,80
2932,2560,2560,JPEG,RGB,False,1,6627e7c7-2fdd-4f3c-965e-b4d73d0a4cc2.jpg,Airplane,948,1027,2368,2433,79,65
2933,2560,2560,JPEG,RGB,False,1,6627e7c7-2fdd-4f3c-965e-b4d73d0a4cc2.jpg,Airplane,1893,1984,1933,2012,91,79
2934,2560,2560,JPEG,RGB,False,1,6627e7c7-2fdd-4f3c-965e-b4d73d0a4cc2.jpg,Airplane,1878,1959,1820,1891,81,71
2935,2560,2560,JPEG,RGB,False,1,a9cc0c57-a46a-4d85-bd97-937cf7ffc6f8.jpg,Airplane,1859,1924,2126,2184,65,58
2936,2560,2560,JPEG,RGB,False,1,a9cc0c57-a46a-4d85-bd97-937cf7ffc6f8.jpg,Airplane,1679,1744,2079,2137,65,58
2937,2560,2560,JPEG,RGB,False,1,a9cc0c57-a46a-4d85-bd97-937cf7ffc6f8.jpg,Airplane,1710,1774,2011,2069,64,58
2938,2560,2560,JPEG,RGB,False,1,a9cc0c57-a46a-4d85-bd97-937cf7ffc6f8.jpg,Airplane,1805,1870,1787,1846,65,59
2939,2560,2560,JPEG,RGB,False,1,a9cc0c57-a46a-4d85-bd97-937cf7ffc6f8.jpg,Airplane,1833,1893,1720,1779,60,59
2940,2560,2560,JPEG,RGB,False,1,a9cc0c57-a46a-4d85-bd97-937cf7ffc6f8.jpg,Airplane,1858,1924,1654,1713,66,59
2941,2560,2560,JPEG,RGB,False,1,a9cc0c57-a46a-4d85-bd97-937cf7ffc6f8.jpg,Airplane,1917,1983,1516,1576,66,60
2942,2560,2560,JPEG,RGB,False,1,a9cc0c57-a46a-4d85-bd97-937cf7ffc6f8.jpg,Airplane,2026,2095,1249,1308,69,59
2943,2560,2560,JPEG,RGB,False,1,a9cc0c57-a46a-4d85-bd97-937cf7ffc6f8.jpg,Airplane,2116,2180,1049,1107,64,58
2944,2560,2560,JPEG,RGB,False,1,a9cc0c57-a46a-4d85-bd97-937cf7ffc6f8.jpg,Airplane,2444,2501,791,861,57,70
2945,2560,2560,JPEG,RGB,False,1,a9cc0c57-a46a-4d85-bd97-937cf7ffc6f8.jpg,Truncated_airplane,2465,2560,240,345,95,105
2946,2560,2560,JPEG,RGB,False,1,a9cc0c57-a46a-4d85-bd97-937cf7ffc6f8.jpg,Airplane,2194,2300,35,145,106,110
2947,2560,2560,JPEG,RGB,False,1,bed88cf9-7887-4bfd-a1d7-b5499ee24f03.jpg,Airplane,562,644,269,341,82,72
2948,2560,2560,JPEG,RGB,False,1,bed88cf9-7887-4bfd-a1d7-b5499ee24f03.jpg,Airplane,599,678,407,466,79,59
2949,2560,2560,JPEG,RGB,False,1,bed88cf9-7887-4bfd-a1d7-b5499ee24f03.jpg,Airplane,627,742,516,602,115,86
2950,2560,2560,JPEG,RGB,False,1,bed88cf9-7887-4bfd-a1d7-b5499ee24f03.jpg,Airplane,745,863,903,997,118,94
2951,2560,2560,JPEG,RGB,False,1,bed88cf9-7887-4bfd-a1d7-b5499ee24f03.jpg,Airplane,800,890,1033,1109,90,76
2952,2560,2560,JPEG,RGB,False,1,bed88cf9-7887-4bfd-a1d7-b5499ee24f03.jpg,Airplane,854,927,1169,1229,73,60
2953,2560,2560,JPEG,RGB,False,1,bed88cf9-7887-4bfd-a1d7-b5499ee24f03.jpg,Airplane,951,1050,1545,1618,99,73
2954,2560,2560,JPEG,RGB,False,1,bed88cf9-7887-4bfd-a1d7-b5499ee24f03.jpg,Airplane,1011,1097,1677,1747,86,70
2955,2560,2560,JPEG,RGB,False,1,bed88cf9-7887-4bfd-a1d7-b5499ee24f03.jpg,Airplane,1037,1140,1804,1870,103,66
2956,2560,2560,JPEG,RGB,False,1,bed88cf9-7887-4bfd-a1d7-b5499ee24f03.jpg,Airplane,1343,1432,1629,1700,89,71
2957,2560,2560,JPEG,RGB,False,1,bed88cf9-7887-4bfd-a1d7-b5499ee24f03.jpg,Airplane,1275,1397,1465,1571,122,106
2958,2560,2560,JPEG,RGB,False,1,bed88cf9-7887-4bfd-a1d7-b5499ee24f03.jpg,Airplane,1219,1308,1211,1280,89,69
2959,2560,2560,JPEG,RGB,False,1,bed88cf9-7887-4bfd-a1d7-b5499ee24f03.jpg,Airplane,1096,1213,913,1016,117,103
2960,2560,2560,JPEG,RGB,False,1,bed88cf9-7887-4bfd-a1d7-b5499ee24f03.jpg,Airplane,1044,1177,774,889,133,115
2961,2560,2560,JPEG,RGB,False,1,bed88cf9-7887-4bfd-a1d7-b5499ee24f03.jpg,Airplane,1046,1118,650,706,72,56
2962,2560,2560,JPEG,RGB,False,1,bed88cf9-7887-4bfd-a1d7-b5499ee24f03.jpg,Airplane,946,1080,493,592,134,99
2963,2560,2560,JPEG,RGB,False,1,bed88cf9-7887-4bfd-a1d7-b5499ee24f03.jpg,Airplane,1264,1339,91,171,75,80
2964,2560,2560,JPEG,RGB,False,1,bed88cf9-7887-4bfd-a1d7-b5499ee24f03.jpg,Truncated_airplane,1653,1743,0,53,90,53
2965,2560,2560,JPEG,RGB,False,1,fca12ef2-0f65-48d0-a4aa-6bae562f2236.jpg,Airplane,812,916,41,131,104,90
2966,2560,2560,JPEG,RGB,False,1,fca12ef2-0f65-48d0-a4aa-6bae562f2236.jpg,Airplane,636,726,210,329,90,119
2967,2560,2560,JPEG,RGB,False,1,fca12ef2-0f65-48d0-a4aa-6bae562f2236.jpg,Airplane,537,623,254,367,86,113
2968,2560,2560,JPEG,RGB,False,1,fca12ef2-0f65-48d0-a4aa-6bae562f2236.jpg,Airplane,347,444,316,435,97,119
2969,2560,2560,JPEG,RGB,False,1,fca12ef2-0f65-48d0-a4aa-6bae562f2236.jpg,Airplane,249,343,358,473,94,115
2970,2560,2560,JPEG,RGB,False,1,fca12ef2-0f65-48d0-a4aa-6bae562f2236.jpg,Airplane,151,245,401,509,94,108
2971,2560,2560,JPEG,RGB,False,1,fca12ef2-0f65-48d0-a4aa-6bae562f2236.jpg,Airplane,46,138,452,545,92,93
2972,2560,2560,JPEG,RGB,False,1,fca12ef2-0f65-48d0-a4aa-6bae562f2236.jpg,Airplane,1545,1636,481,582,91,101
2973,2560,2560,JPEG,RGB,False,1,56e2d3d3-6b16-401f-a300-847272373df5.jpg,Airplane,751,790,206,268,39,62
2974,2560,2560,JPEG,RGB,False,1,56e2d3d3-6b16-401f-a300-847272373df5.jpg,Airplane,533,579,223,284,46,61
2975,2560,2560,JPEG,RGB,False,1,56e2d3d3-6b16-401f-a300-847272373df5.jpg,Airplane,382,444,325,368,62,43
2976,2560,2560,JPEG,RGB,False,1,56e2d3d3-6b16-401f-a300-847272373df5.jpg,Airplane,811,887,284,341,76,57
2977,2560,2560,JPEG,RGB,False,1,56e2d3d3-6b16-401f-a300-847272373df5.jpg,Airplane,1056,1111,334,409,55,75
2978,2560,2560,JPEG,RGB,False,1,56e2d3d3-6b16-401f-a300-847272373df5.jpg,Airplane,858,902,367,431,44,64
2979,2560,2560,JPEG,RGB,False,1,56e2d3d3-6b16-401f-a300-847272373df5.jpg,Airplane,779,836,381,449,57,68
2980,2560,2560,JPEG,RGB,False,1,56e2d3d3-6b16-401f-a300-847272373df5.jpg,Airplane,713,768,395,464,55,69
2981,2560,2560,JPEG,RGB,False,1,56e2d3d3-6b16-401f-a300-847272373df5.jpg,Airplane,654,715,425,492,61,67
2982,2560,2560,JPEG,RGB,False,1,56e2d3d3-6b16-401f-a300-847272373df5.jpg,Airplane,1691,1771,388,481,80,93
2983,2560,2560,JPEG,RGB,False,1,56e2d3d3-6b16-401f-a300-847272373df5.jpg,Airplane,1780,1857,415,482,77,67
2984,2560,2560,JPEG,RGB,False,1,56e2d3d3-6b16-401f-a300-847272373df5.jpg,Airplane,2415,2477,629,718,62,89
2985,2560,2560,JPEG,RGB,False,1,56e2d3d3-6b16-401f-a300-847272373df5.jpg,Airplane,157,239,1466,1519,82,53
2986,2560,2560,JPEG,RGB,False,1,56e2d3d3-6b16-401f-a300-847272373df5.jpg,Airplane,286,348,1648,1701,62,53
2987,2560,2560,JPEG,RGB,False,1,56e2d3d3-6b16-401f-a300-847272373df5.jpg,Airplane,347,409,1697,1754,62,57
2988,2560,2560,JPEG,RGB,False,1,56e2d3d3-6b16-401f-a300-847272373df5.jpg,Airplane,959,1046,1782,1835,87,53
2989,2560,2560,JPEG,RGB,False,1,56e2d3d3-6b16-401f-a300-847272373df5.jpg,Airplane,1623,1693,1711,1790,70,79
2990,2560,2560,JPEG,RGB,False,1,56e2d3d3-6b16-401f-a300-847272373df5.jpg,Airplane,1717,1783,1709,1788,66,79
2991,2560,2560,JPEG,RGB,False,1,56e2d3d3-6b16-401f-a300-847272373df5.jpg,Airplane,1792,1872,1689,1781,80,92
2992,2560,2560,JPEG,RGB,False,1,56e2d3d3-6b16-401f-a300-847272373df5.jpg,Airplane,954,1016,1691,1762,62,71
2993,2560,2560,JPEG,RGB,False,1,56e2d3d3-6b16-401f-a300-847272373df5.jpg,Airplane,502,543,418,493,41,75
2994,2560,2560,JPEG,RGB,False,1,56e2d3d3-6b16-401f-a300-847272373df5.jpg,Airplane,447,488,419,480,41,61
2995,2560,2560,JPEG,RGB,False,1,56e2d3d3-6b16-401f-a300-847272373df5.jpg,Airplane,391,437,413,470,46,57
2996,2560,2560,JPEG,RGB,False,1,56e2d3d3-6b16-401f-a300-847272373df5.jpg,Airplane,248,308,468,514,60,46
2997,2560,2560,JPEG,RGB,False,1,56e2d3d3-6b16-401f-a300-847272373df5.jpg,Airplane,225,305,518,562,80,44
2998,2560,2560,JPEG,RGB,False,1,56e2d3d3-6b16-401f-a300-847272373df5.jpg,Airplane,352,419,582,630,67,48
2999,2560,2560,JPEG,RGB,False,1,56e2d3d3-6b16-401f-a300-847272373df5.jpg,Airplane,456,520,595,637,64,42
3000,2560,2560,JPEG,RGB,False,1,56e2d3d3-6b16-401f-a300-847272373df5.jpg,Airplane,440,498,663,709,58,46
3001,2560,2560,JPEG,RGB,False,1,56e2d3d3-6b16-401f-a300-847272373df5.jpg,Airplane,221,272,831,910,51,79
3002,2560,2560,JPEG,RGB,False,1,56e2d3d3-6b16-401f-a300-847272373df5.jpg,Airplane,354,424,874,927,70,53
3003,2560,2560,JPEG,RGB,False,1,56e2d3d3-6b16-401f-a300-847272373df5.jpg,Airplane,327,391,1005,1054,64,49
3004,2560,2560,JPEG,RGB,False,1,56e2d3d3-6b16-401f-a300-847272373df5.jpg,Airplane,298,365,1069,1119,67,50
3005,2560,2560,JPEG,RGB,False,1,56e2d3d3-6b16-401f-a300-847272373df5.jpg,Airplane,309,383,1137,1188,74,51
3006,2560,2560,JPEG,RGB,False,1,56e2d3d3-6b16-401f-a300-847272373df5.jpg,Airplane,352,410,1181,1245,58,64
3007,2560,2560,JPEG,RGB,False,1,56e2d3d3-6b16-401f-a300-847272373df5.jpg,Airplane,516,581,1534,1596,65,62
3008,2560,2560,JPEG,RGB,False,1,56e2d3d3-6b16-401f-a300-847272373df5.jpg,Airplane,629,687,1601,1673,58,72
3009,2560,2560,JPEG,RGB,False,1,56e2d3d3-6b16-401f-a300-847272373df5.jpg,Airplane,682,741,1657,1719,59,62
3010,2560,2560,JPEG,RGB,False,1,56e2d3d3-6b16-401f-a300-847272373df5.jpg,Airplane,742,799,1668,1743,57,75
3011,2560,2560,JPEG,RGB,False,1,56e2d3d3-6b16-401f-a300-847272373df5.jpg,Airplane,808,863,1659,1727,55,68
3012,2560,2560,JPEG,RGB,False,1,56e2d3d3-6b16-401f-a300-847272373df5.jpg,Airplane,879,937,1660,1747,58,87
3013,2560,2560,JPEG,RGB,False,1,56e2d3d3-6b16-401f-a300-847272373df5.jpg,Airplane,1954,2053,388,502,99,114
3014,2560,2560,JPEG,RGB,False,1,56e2d3d3-6b16-401f-a300-847272373df5.jpg,Airplane,2047,2136,450,540,89,90
3015,2560,2560,JPEG,RGB,False,1,56e2d3d3-6b16-401f-a300-847272373df5.jpg,Airplane,2110,2186,518,591,76,73
3016,2560,2560,JPEG,RGB,False,1,56e2d3d3-6b16-401f-a300-847272373df5.jpg,Airplane,2177,2256,576,658,79,82
3017,2560,2560,JPEG,RGB,False,1,56e2d3d3-6b16-401f-a300-847272373df5.jpg,Airplane,2261,2371,702,782,110,80
3018,2560,2560,JPEG,RGB,False,1,56e2d3d3-6b16-401f-a300-847272373df5.jpg,Airplane,2288,2389,789,865,101,76
3019,2560,2560,JPEG,RGB,False,1,56e2d3d3-6b16-401f-a300-847272373df5.jpg,Airplane,2311,2417,869,940,106,71
3020,2560,2560,JPEG,RGB,False,1,56e2d3d3-6b16-401f-a300-847272373df5.jpg,Airplane,2315,2438,947,1051,123,104
3021,2560,2560,JPEG,RGB,False,1,56e2d3d3-6b16-401f-a300-847272373df5.jpg,Airplane,2324,2435,1060,1142,111,82
3022,2560,2560,JPEG,RGB,False,1,56e2d3d3-6b16-401f-a300-847272373df5.jpg,Airplane,2335,2428,1149,1217,93,68
3023,2560,2560,JPEG,RGB,False,1,56e2d3d3-6b16-401f-a300-847272373df5.jpg,Airplane,2247,2351,1344,1419,104,75
3024,2560,2560,JPEG,RGB,False,1,56e2d3d3-6b16-401f-a300-847272373df5.jpg,Airplane,2229,2326,1439,1521,97,82
3025,2560,2560,JPEG,RGB,False,1,56e2d3d3-6b16-401f-a300-847272373df5.jpg,Airplane,2191,2288,1518,1604,97,86
3026,2560,2560,JPEG,RGB,False,1,56e2d3d3-6b16-401f-a300-847272373df5.jpg,Airplane,2152,2225,1587,1674,73,87
3027,2560,2560,JPEG,RGB,False,1,56e2d3d3-6b16-401f-a300-847272373df5.jpg,Airplane,2068,2137,1632,1718,69,86
3028,2560,2560,JPEG,RGB,False,1,56e2d3d3-6b16-401f-a300-847272373df5.jpg,Airplane,1989,2057,1689,1773,68,84
3029,2560,2560,JPEG,RGB,False,1,56e2d3d3-6b16-401f-a300-847272373df5.jpg,Airplane,1886,1961,1693,1791,75,98
3030,2560,2560,JPEG,RGB,False,1,56e2d3d3-6b16-401f-a300-847272373df5.jpg,Airplane,945,1029,1896,1960,84,64
3031,2560,2560,JPEG,RGB,False,1,56e2d3d3-6b16-401f-a300-847272373df5.jpg,Airplane,992,1060,1997,2099,68,102
3032,2560,2560,JPEG,RGB,False,1,56e2d3d3-6b16-401f-a300-847272373df5.jpg,Airplane,479,615,2031,2163,136,132
3033,2560,2560,JPEG,RGB,False,1,56e2d3d3-6b16-401f-a300-847272373df5.jpg,Airplane,280,419,2436,2550,139,114
3034,2560,2560,JPEG,RGB,False,1,56e2d3d3-6b16-401f-a300-847272373df5.jpg,Airplane,2234,2303,2020,2122,69,102
3035,2560,2560,JPEG,RGB,False,1,56e2d3d3-6b16-401f-a300-847272373df5.jpg,Airplane,2379,2456,2215,2290,77,75
3036,2560,2560,JPEG,RGB,False,1,56e2d3d3-6b16-401f-a300-847272373df5.jpg,Airplane,2324,2425,2344,2417,101,73
3037,2560,2560,JPEG,RGB,False,1,56e2d3d3-6b16-401f-a300-847272373df5.jpg,Airplane,2075,2148,2047,2143,73,96
3038,2560,2560,JPEG,RGB,False,1,56e2d3d3-6b16-401f-a300-847272373df5.jpg,Airplane,2013,2070,1981,2073,57,92
3039,2560,2560,JPEG,RGB,False,1,56e2d3d3-6b16-401f-a300-847272373df5.jpg,Airplane,1916,1990,1974,2070,74,96
3040,2560,2560,JPEG,RGB,False,1,56e2d3d3-6b16-401f-a300-847272373df5.jpg,Airplane,1832,1897,1952,2054,65,102
3041,2560,2560,JPEG,RGB,False,1,56e2d3d3-6b16-401f-a300-847272373df5.jpg,Airplane,1728,1806,1936,2032,78,96
3042,2560,2560,JPEG,RGB,False,1,56e2d3d3-6b16-401f-a300-847272373df5.jpg,Airplane,1627,1698,1929,2036,71,107
3043,2560,2560,JPEG,RGB,False,1,56e2d3d3-6b16-401f-a300-847272373df5.jpg,Truncated_airplane,2317,2401,2513,2557,84,44
3044,2560,2560,JPEG,RGB,False,1,11928d1c-44c7-4d3d-b593-9cdfd5f6f367.jpg,Airplane,927,1000,521,592,73,71
3045,2560,2560,JPEG,RGB,False,1,11928d1c-44c7-4d3d-b593-9cdfd5f6f367.jpg,Airplane,885,994,635,737,109,102
3046,2560,2560,JPEG,RGB,False,1,11928d1c-44c7-4d3d-b593-9cdfd5f6f367.jpg,Airplane,833,968,759,867,135,108
3047,2560,2560,JPEG,RGB,False,1,11928d1c-44c7-4d3d-b593-9cdfd5f6f367.jpg,Airplane,800,915,883,996,115,113
3048,2560,2560,JPEG,RGB,False,1,11928d1c-44c7-4d3d-b593-9cdfd5f6f367.jpg,Airplane,553,622,900,961,69,61
3049,2560,2560,JPEG,RGB,False,1,11928d1c-44c7-4d3d-b593-9cdfd5f6f367.jpg,Airplane,446,554,1001,1137,108,136
3050,2560,2560,JPEG,RGB,False,1,11928d1c-44c7-4d3d-b593-9cdfd5f6f367.jpg,Airplane,580,650,1063,1138,70,75
3051,2560,2560,JPEG,RGB,False,1,11928d1c-44c7-4d3d-b593-9cdfd5f6f367.jpg,Airplane,402,466,1317,1390,64,73
3052,2560,2560,JPEG,RGB,False,1,11928d1c-44c7-4d3d-b593-9cdfd5f6f367.jpg,Airplane,619,686,1365,1445,67,80
3053,2560,2560,JPEG,RGB,False,1,11928d1c-44c7-4d3d-b593-9cdfd5f6f367.jpg,Airplane,688,762,1518,1582,74,64
3054,2560,2560,JPEG,RGB,False,1,11928d1c-44c7-4d3d-b593-9cdfd5f6f367.jpg,Airplane,631,744,1613,1729,113,116
3055,2560,2560,JPEG,RGB,False,1,11928d1c-44c7-4d3d-b593-9cdfd5f6f367.jpg,Airplane,418,493,1846,1926,75,80
3056,2560,2560,JPEG,RGB,False,1,11928d1c-44c7-4d3d-b593-9cdfd5f6f367.jpg,Airplane,629,697,1775,1835,68,60
3057,2560,2560,JPEG,RGB,False,1,11928d1c-44c7-4d3d-b593-9cdfd5f6f367.jpg,Airplane,231,304,2166,2229,73,63
3058,2560,2560,JPEG,RGB,False,1,11928d1c-44c7-4d3d-b593-9cdfd5f6f367.jpg,Airplane,548,628,2024,2094,80,70
3059,2560,2560,JPEG,RGB,False,1,11928d1c-44c7-4d3d-b593-9cdfd5f6f367.jpg,Airplane,872,993,1826,1934,121,108
3060,2560,2560,JPEG,RGB,False,1,11928d1c-44c7-4d3d-b593-9cdfd5f6f367.jpg,Airplane,846,954,1960,2060,108,100
3061,2560,2560,JPEG,RGB,False,1,11928d1c-44c7-4d3d-b593-9cdfd5f6f367.jpg,Airplane,812,921,2078,2192,109,114
3062,2560,2560,JPEG,RGB,False,1,11928d1c-44c7-4d3d-b593-9cdfd5f6f367.jpg,Airplane,1303,1414,1525,1654,111,129
3063,2560,2560,JPEG,RGB,False,1,11928d1c-44c7-4d3d-b593-9cdfd5f6f367.jpg,Airplane,1976,2030,1708,1785,54,77
3064,2560,2560,JPEG,RGB,False,1,11928d1c-44c7-4d3d-b593-9cdfd5f6f367.jpg,Airplane,1828,1934,1664,1797,106,133
3065,2560,2560,JPEG,RGB,False,1,11928d1c-44c7-4d3d-b593-9cdfd5f6f367.jpg,Airplane,1706,1806,1634,1771,100,137
3066,2560,2560,JPEG,RGB,False,1,11928d1c-44c7-4d3d-b593-9cdfd5f6f367.jpg,Airplane,1579,1690,1600,1739,111,139
3067,2560,2560,JPEG,RGB,False,1,11928d1c-44c7-4d3d-b593-9cdfd5f6f367.jpg,Airplane,1586,1675,1891,1980,89,89
3068,2560,2560,JPEG,RGB,False,1,11928d1c-44c7-4d3d-b593-9cdfd5f6f367.jpg,Airplane,2002,2128,1837,1957,126,120
3069,2560,2560,JPEG,RGB,False,1,11928d1c-44c7-4d3d-b593-9cdfd5f6f367.jpg,Airplane,1697,1817,1945,2088,120,143
3070,2560,2560,JPEG,RGB,False,1,11928d1c-44c7-4d3d-b593-9cdfd5f6f367.jpg,Airplane,1979,2098,1979,2080,119,101
3071,2560,2560,JPEG,RGB,False,1,11928d1c-44c7-4d3d-b593-9cdfd5f6f367.jpg,Airplane,2231,2338,2175,2282,107,107
3072,2560,2560,JPEG,RGB,False,1,11928d1c-44c7-4d3d-b593-9cdfd5f6f367.jpg,Airplane,2189,2309,2305,2417,120,112
3073,2560,2560,JPEG,RGB,False,1,11928d1c-44c7-4d3d-b593-9cdfd5f6f367.jpg,Airplane,1882,2001,2356,2461,119,105
3074,2560,2560,JPEG,RGB,False,1,11928d1c-44c7-4d3d-b593-9cdfd5f6f367.jpg,Airplane,1331,1402,1836,1901,71,65
3075,2560,2560,JPEG,RGB,False,1,11928d1c-44c7-4d3d-b593-9cdfd5f6f367.jpg,Airplane,1494,1538,2278,2332,44,54
3076,2560,2560,JPEG,RGB,False,1,11928d1c-44c7-4d3d-b593-9cdfd5f6f367.jpg,Airplane,2463,2529,1337,1406,66,69
3077,2560,2560,JPEG,RGB,False,1,11928d1c-44c7-4d3d-b593-9cdfd5f6f367.jpg,Airplane,2428,2497,1444,1496,69,52
3078,2560,2560,JPEG,RGB,False,1,57af3c0a-b5ae-4e4f-a7f9-6856be2f80e5.jpg,Airplane,947,1034,202,257,87,55
3079,2560,2560,JPEG,RGB,False,1,57af3c0a-b5ae-4e4f-a7f9-6856be2f80e5.jpg,Airplane,961,1037,276,334,76,58
3080,2560,2560,JPEG,RGB,False,1,57af3c0a-b5ae-4e4f-a7f9-6856be2f80e5.jpg,Airplane,917,991,335,394,74,59
3081,2560,2560,JPEG,RGB,False,1,57af3c0a-b5ae-4e4f-a7f9-6856be2f80e5.jpg,Airplane,934,1004,410,467,70,57
3082,2560,2560,JPEG,RGB,False,1,57af3c0a-b5ae-4e4f-a7f9-6856be2f80e5.jpg,Airplane,955,985,489,518,30,29
3083,2560,2560,JPEG,RGB,False,1,57af3c0a-b5ae-4e4f-a7f9-6856be2f80e5.jpg,Airplane,864,931,668,728,67,60
3084,2560,2560,JPEG,RGB,False,1,57af3c0a-b5ae-4e4f-a7f9-6856be2f80e5.jpg,Airplane,841,896,833,880,55,47
3085,2560,2560,JPEG,RGB,False,1,57af3c0a-b5ae-4e4f-a7f9-6856be2f80e5.jpg,Airplane,976,1028,914,967,52,53
3086,2560,2560,JPEG,RGB,False,1,57af3c0a-b5ae-4e4f-a7f9-6856be2f80e5.jpg,Airplane,1091,1215,907,1015,124,108
3087,2560,2560,JPEG,RGB,False,1,57af3c0a-b5ae-4e4f-a7f9-6856be2f80e5.jpg,Airplane,1221,1329,421,534,108,113
3088,2560,2560,JPEG,RGB,False,1,57af3c0a-b5ae-4e4f-a7f9-6856be2f80e5.jpg,Airplane,1327,1400,221,295,73,74
3089,2560,2560,JPEG,RGB,False,1,57af3c0a-b5ae-4e4f-a7f9-6856be2f80e5.jpg,Airplane,1434,1493,544,615,59,71
3090,2560,2560,JPEG,RGB,False,1,57af3c0a-b5ae-4e4f-a7f9-6856be2f80e5.jpg,Airplane,1488,1603,953,1068,115,115
3091,2560,2560,JPEG,RGB,False,1,57af3c0a-b5ae-4e4f-a7f9-6856be2f80e5.jpg,Airplane,1501,1578,1370,1433,77,63
3092,2560,2560,JPEG,RGB,False,1,57af3c0a-b5ae-4e4f-a7f9-6856be2f80e5.jpg,Airplane,1696,1786,1552,1661,90,109
3093,2560,2560,JPEG,RGB,False,1,57af3c0a-b5ae-4e4f-a7f9-6856be2f80e5.jpg,Airplane,1313,1379,1739,1815,66,76
3094,2560,2560,JPEG,RGB,False,1,57af3c0a-b5ae-4e4f-a7f9-6856be2f80e5.jpg,Airplane,1018,1144,1163,1269,126,106
3095,2560,2560,JPEG,RGB,False,1,57af3c0a-b5ae-4e4f-a7f9-6856be2f80e5.jpg,Airplane,753,829,1041,1105,76,64
3096,2560,2560,JPEG,RGB,False,1,57af3c0a-b5ae-4e4f-a7f9-6856be2f80e5.jpg,Airplane,679,745,1342,1408,66,66
3097,2560,2560,JPEG,RGB,False,1,57af3c0a-b5ae-4e4f-a7f9-6856be2f80e5.jpg,Airplane,828,898,1597,1664,70,67
3098,2560,2560,JPEG,RGB,False,1,57af3c0a-b5ae-4e4f-a7f9-6856be2f80e5.jpg,Truncated_airplane,0,33,1680,1752,33,72
3099,2560,2560,JPEG,RGB,False,1,57af3c0a-b5ae-4e4f-a7f9-6856be2f80e5.jpg,Truncated_airplane,688,831,2432,2562,143,130
3100,2560,2560,JPEG,RGB,False,1,57af3c0a-b5ae-4e4f-a7f9-6856be2f80e5.jpg,Airplane,188,251,1728,1785,63,57
3101,2560,2560,JPEG,RGB,False,1,57af3c0a-b5ae-4e4f-a7f9-6856be2f80e5.jpg,Airplane,207,342,1837,1961,135,124
3102,2560,2560,JPEG,RGB,False,1,57af3c0a-b5ae-4e4f-a7f9-6856be2f80e5.jpg,Airplane,90,220,2358,2472,130,114
3103,2560,2560,JPEG,RGB,False,1,57af3c0a-b5ae-4e4f-a7f9-6856be2f80e5.jpg,Airplane,29,142,2103,2213,113,110
3104,2560,2560,JPEG,RGB,False,1,57af3c0a-b5ae-4e4f-a7f9-6856be2f80e5.jpg,Airplane,397,543,2306,2411,146,105
3105,2560,2560,JPEG,RGB,False,1,57af3c0a-b5ae-4e4f-a7f9-6856be2f80e5.jpg,Airplane,446,571,2176,2288,125,112
3106,2560,2560,JPEG,RGB,False,1,57af3c0a-b5ae-4e4f-a7f9-6856be2f80e5.jpg,Airplane,470,589,2056,2155,119,99
3107,2560,2560,JPEG,RGB,False,1,57af3c0a-b5ae-4e4f-a7f9-6856be2f80e5.jpg,Airplane,515,633,1929,2026,118,97
3108,2560,2560,JPEG,RGB,False,1,57af3c0a-b5ae-4e4f-a7f9-6856be2f80e5.jpg,Airplane,664,732,1847,1907,68,60
3109,2560,2560,JPEG,RGB,False,1,57af3c0a-b5ae-4e4f-a7f9-6856be2f80e5.jpg,Airplane,850,957,1878,1989,107,111
3110,2560,2560,JPEG,RGB,False,1,57af3c0a-b5ae-4e4f-a7f9-6856be2f80e5.jpg,Airplane,1256,1345,1908,2006,89,98
3111,2560,2560,JPEG,RGB,False,1,57af3c0a-b5ae-4e4f-a7f9-6856be2f80e5.jpg,Airplane,1275,1382,1048,1167,107,119
3112,2560,2560,JPEG,RGB,False,1,996ba764-cd2a-49c0-9c9f-b166207de0ab.jpg,Airplane,513,601,839,913,88,74
3113,2560,2560,JPEG,RGB,False,1,996ba764-cd2a-49c0-9c9f-b166207de0ab.jpg,Airplane,548,609,927,979,61,52
3114,2560,2560,JPEG,RGB,False,1,996ba764-cd2a-49c0-9c9f-b166207de0ab.jpg,Airplane,691,759,1151,1218,68,67
3115,2560,2560,JPEG,RGB,False,1,996ba764-cd2a-49c0-9c9f-b166207de0ab.jpg,Airplane,698,755,1325,1390,57,65
3116,2560,2560,JPEG,RGB,False,1,996ba764-cd2a-49c0-9c9f-b166207de0ab.jpg,Airplane,571,635,1456,1515,64,59
3117,2560,2560,JPEG,RGB,False,1,996ba764-cd2a-49c0-9c9f-b166207de0ab.jpg,Airplane,537,623,1690,1759,86,69
3118,2560,2560,JPEG,RGB,False,1,996ba764-cd2a-49c0-9c9f-b166207de0ab.jpg,Airplane,548,627,1784,1852,79,68
3119,2560,2560,JPEG,RGB,False,1,996ba764-cd2a-49c0-9c9f-b166207de0ab.jpg,Airplane,558,647,1870,1943,89,73
3120,2560,2560,JPEG,RGB,False,1,996ba764-cd2a-49c0-9c9f-b166207de0ab.jpg,Airplane,556,646,1965,2041,90,76
3121,2560,2560,JPEG,RGB,False,1,996ba764-cd2a-49c0-9c9f-b166207de0ab.jpg,Airplane,543,647,2057,2134,104,77
3122,2560,2560,JPEG,RGB,False,1,996ba764-cd2a-49c0-9c9f-b166207de0ab.jpg,Airplane,527,630,2168,2250,103,82
3123,2560,2560,JPEG,RGB,False,1,996ba764-cd2a-49c0-9c9f-b166207de0ab.jpg,Airplane,932,1025,873,948,93,75
3124,2560,2560,JPEG,RGB,False,1,996ba764-cd2a-49c0-9c9f-b166207de0ab.jpg,Airplane,941,1035,1040,1120,94,80
3125,2560,2560,JPEG,RGB,False,1,996ba764-cd2a-49c0-9c9f-b166207de0ab.jpg,Airplane,929,1029,1126,1216,100,90
3126,2560,2560,JPEG,RGB,False,1,996ba764-cd2a-49c0-9c9f-b166207de0ab.jpg,Airplane,922,1022,1215,1306,100,91
3127,2560,2560,JPEG,RGB,False,1,996ba764-cd2a-49c0-9c9f-b166207de0ab.jpg,Airplane,934,1032,1592,1663,98,71
3128,2560,2560,JPEG,RGB,False,1,996ba764-cd2a-49c0-9c9f-b166207de0ab.jpg,Airplane,936,1030,1693,1772,94,79
3129,2560,2560,JPEG,RGB,False,1,996ba764-cd2a-49c0-9c9f-b166207de0ab.jpg,Airplane,957,1028,1810,1886,71,76
3130,2560,2560,JPEG,RGB,False,1,996ba764-cd2a-49c0-9c9f-b166207de0ab.jpg,Airplane,945,1042,1922,2007,97,85
3131,2560,2560,JPEG,RGB,False,1,996ba764-cd2a-49c0-9c9f-b166207de0ab.jpg,Airplane,933,1037,2141,2227,104,86
3132,2560,2560,JPEG,RGB,False,1,996ba764-cd2a-49c0-9c9f-b166207de0ab.jpg,Airplane,1276,1355,953,1033,79,80
3133,2560,2560,JPEG,RGB,False,1,996ba764-cd2a-49c0-9c9f-b166207de0ab.jpg,Airplane,1143,1241,1004,1092,98,88
3134,2560,2560,JPEG,RGB,False,1,996ba764-cd2a-49c0-9c9f-b166207de0ab.jpg,Airplane,1154,1245,1312,1382,91,70
3135,2560,2560,JPEG,RGB,False,1,996ba764-cd2a-49c0-9c9f-b166207de0ab.jpg,Airplane,1142,1255,1414,1504,113,90
3136,2560,2560,JPEG,RGB,False,1,996ba764-cd2a-49c0-9c9f-b166207de0ab.jpg,Airplane,1149,1245,1864,1945,96,81
3137,2560,2560,JPEG,RGB,False,1,996ba764-cd2a-49c0-9c9f-b166207de0ab.jpg,Airplane,1159,1251,2052,2125,92,73
3138,2560,2560,JPEG,RGB,False,1,996ba764-cd2a-49c0-9c9f-b166207de0ab.jpg,Airplane,1166,1250,2148,2220,84,72
3139,2560,2560,JPEG,RGB,False,1,996ba764-cd2a-49c0-9c9f-b166207de0ab.jpg,Airplane,1159,1250,2236,2308,91,72
3140,2560,2560,JPEG,RGB,False,1,996ba764-cd2a-49c0-9c9f-b166207de0ab.jpg,Airplane,1769,1860,850,917,91,67
3141,2560,2560,JPEG,RGB,False,1,996ba764-cd2a-49c0-9c9f-b166207de0ab.jpg,Airplane,1957,2039,691,761,82,70
3142,2560,2560,JPEG,RGB,False,1,996ba764-cd2a-49c0-9c9f-b166207de0ab.jpg,Airplane,1540,1636,938,1006,96,68
3143,2560,2560,JPEG,RGB,False,1,996ba764-cd2a-49c0-9c9f-b166207de0ab.jpg,Airplane,1764,1861,936,1007,97,71
3144,2560,2560,JPEG,RGB,False,1,996ba764-cd2a-49c0-9c9f-b166207de0ab.jpg,Airplane,1776,1858,1030,1101,82,71
3145,2560,2560,JPEG,RGB,False,1,996ba764-cd2a-49c0-9c9f-b166207de0ab.jpg,Airplane,1767,1867,1310,1375,100,65
3146,2560,2560,JPEG,RGB,False,1,996ba764-cd2a-49c0-9c9f-b166207de0ab.jpg,Airplane,1543,1617,1385,1456,74,71
3147,2560,2560,JPEG,RGB,False,1,996ba764-cd2a-49c0-9c9f-b166207de0ab.jpg,Airplane,1544,1631,1476,1543,87,67
3148,2560,2560,JPEG,RGB,False,1,996ba764-cd2a-49c0-9c9f-b166207de0ab.jpg,Airplane,1776,1866,1402,1467,90,65
3149,2560,2560,JPEG,RGB,False,1,996ba764-cd2a-49c0-9c9f-b166207de0ab.jpg,Airplane,1780,1870,1479,1548,90,69
3150,2560,2560,JPEG,RGB,False,1,996ba764-cd2a-49c0-9c9f-b166207de0ab.jpg,Airplane,1778,1853,1606,1684,75,78
3151,2560,2560,JPEG,RGB,False,1,996ba764-cd2a-49c0-9c9f-b166207de0ab.jpg,Airplane,1762,1851,1707,1770,89,63
3152,2560,2560,JPEG,RGB,False,1,996ba764-cd2a-49c0-9c9f-b166207de0ab.jpg,Airplane,1758,1855,1797,1862,97,65
3153,2560,2560,JPEG,RGB,False,1,996ba764-cd2a-49c0-9c9f-b166207de0ab.jpg,Airplane,1752,1844,1890,1957,92,67
3154,2560,2560,JPEG,RGB,False,1,996ba764-cd2a-49c0-9c9f-b166207de0ab.jpg,Airplane,1765,1856,2069,2141,91,72
3155,2560,2560,JPEG,RGB,False,1,996ba764-cd2a-49c0-9c9f-b166207de0ab.jpg,Airplane,1769,1862,2164,2237,93,73
3156,2560,2560,JPEG,RGB,False,1,996ba764-cd2a-49c0-9c9f-b166207de0ab.jpg,Airplane,1544,1642,1799,1863,98,64
3157,2560,2560,JPEG,RGB,False,1,996ba764-cd2a-49c0-9c9f-b166207de0ab.jpg,Airplane,1541,1637,1892,1961,96,69
3158,2560,2560,JPEG,RGB,False,1,996ba764-cd2a-49c0-9c9f-b166207de0ab.jpg,Airplane,1539,1644,1983,2048,105,65
3159,2560,2560,JPEG,RGB,False,1,996ba764-cd2a-49c0-9c9f-b166207de0ab.jpg,Airplane,1541,1642,2165,2233,101,68
3160,2560,2560,JPEG,RGB,False,1,996ba764-cd2a-49c0-9c9f-b166207de0ab.jpg,Airplane,2378,2453,861,924,75,63
3161,2560,2560,JPEG,RGB,False,1,996ba764-cd2a-49c0-9c9f-b166207de0ab.jpg,Airplane,2404,2484,1021,1084,80,63
3162,2560,2560,JPEG,RGB,False,1,996ba764-cd2a-49c0-9c9f-b166207de0ab.jpg,Airplane,2153,2239,1035,1096,86,61
3163,2560,2560,JPEG,RGB,False,1,996ba764-cd2a-49c0-9c9f-b166207de0ab.jpg,Airplane,2394,2469,1188,1251,75,63
3164,2560,2560,JPEG,RGB,False,1,996ba764-cd2a-49c0-9c9f-b166207de0ab.jpg,Airplane,2152,2237,1289,1346,85,57
3165,2560,2560,JPEG,RGB,False,1,996ba764-cd2a-49c0-9c9f-b166207de0ab.jpg,Airplane,2154,2244,1369,1422,90,53
3166,2560,2560,JPEG,RGB,False,1,996ba764-cd2a-49c0-9c9f-b166207de0ab.jpg,Airplane,2394,2482,1346,1405,88,59
3167,2560,2560,JPEG,RGB,False,1,996ba764-cd2a-49c0-9c9f-b166207de0ab.jpg,Airplane,2401,2482,1429,1483,81,54
3168,2560,2560,JPEG,RGB,False,1,996ba764-cd2a-49c0-9c9f-b166207de0ab.jpg,Airplane,2389,2469,1565,1649,80,84
3169,2560,2560,JPEG,RGB,False,1,996ba764-cd2a-49c0-9c9f-b166207de0ab.jpg,Airplane,2384,2464,1912,1984,80,72
3170,2560,2560,JPEG,RGB,False,1,996ba764-cd2a-49c0-9c9f-b166207de0ab.jpg,Airplane,2388,2463,2006,2062,75,56
3171,2560,2560,JPEG,RGB,False,1,996ba764-cd2a-49c0-9c9f-b166207de0ab.jpg,Airplane,2165,2235,1992,2068,70,76
3172,2560,2560,JPEG,RGB,False,1,996ba764-cd2a-49c0-9c9f-b166207de0ab.jpg,Airplane,2047,2104,2166,2265,57,99
3173,2560,2560,JPEG,RGB,False,1,996ba764-cd2a-49c0-9c9f-b166207de0ab.jpg,Airplane,2362,2427,2244,2319,65,75
3174,2560,2560,JPEG,RGB,False,1,996ba764-cd2a-49c0-9c9f-b166207de0ab.jpg,Airplane,1237,1310,495,562,73,67
3175,2560,2560,JPEG,RGB,False,1,996ba764-cd2a-49c0-9c9f-b166207de0ab.jpg,Airplane,2148,2206,190,237,58,47
3176,2560,2560,JPEG,RGB,False,1,22291e0b-ebe2-4f3f-b53e-4e709179300a.jpg,Airplane,95,190,1574,1689,95,115
3177,2560,2560,JPEG,RGB,False,1,22291e0b-ebe2-4f3f-b53e-4e709179300a.jpg,Airplane,2322,2489,716,910,167,194
3178,2560,2560,JPEG,RGB,False,1,22291e0b-ebe2-4f3f-b53e-4e709179300a.jpg,Airplane,1581,1664,1089,1183,83,94
3179,2560,2560,JPEG,RGB,False,1,22291e0b-ebe2-4f3f-b53e-4e709179300a.jpg,Airplane,1317,1459,1112,1264,142,152
3180,2560,2560,JPEG,RGB,False,1,22291e0b-ebe2-4f3f-b53e-4e709179300a.jpg,Airplane,916,1082,1255,1423,166,168
3181,2560,2560,JPEG,RGB,False,1,22291e0b-ebe2-4f3f-b53e-4e709179300a.jpg,Airplane,649,851,1351,1544,202,193
3182,2560,2560,JPEG,RGB,False,1,22291e0b-ebe2-4f3f-b53e-4e709179300a.jpg,Airplane,458,619,1433,1620,161,187
3183,2560,2560,JPEG,RGB,False,1,22291e0b-ebe2-4f3f-b53e-4e709179300a.jpg,Airplane,234,418,1497,1698,184,201
3184,2560,2560,JPEG,RGB,False,1,22291e0b-ebe2-4f3f-b53e-4e709179300a.jpg,Airplane,2405,2498,1239,1348,93,109
3185,2560,2560,JPEG,RGB,False,1,22291e0b-ebe2-4f3f-b53e-4e709179300a.jpg,Airplane,2285,2376,1293,1413,91,120
3186,2560,2560,JPEG,RGB,False,1,22291e0b-ebe2-4f3f-b53e-4e709179300a.jpg,Airplane,2119,2247,1326,1473,128,147
3187,2560,2560,JPEG,RGB,False,1,22291e0b-ebe2-4f3f-b53e-4e709179300a.jpg,Airplane,1877,1992,1415,1564,115,149
3188,2560,2560,JPEG,RGB,False,1,22291e0b-ebe2-4f3f-b53e-4e709179300a.jpg,Airplane,1725,1833,1443,1561,108,118
3189,2560,2560,JPEG,RGB,False,1,22291e0b-ebe2-4f3f-b53e-4e709179300a.jpg,Airplane,1624,1717,1530,1625,93,95
3190,2560,2560,JPEG,RGB,False,1,22291e0b-ebe2-4f3f-b53e-4e709179300a.jpg,Airplane,1217,1307,1707,1804,90,97
3191,2560,2560,JPEG,RGB,False,1,22291e0b-ebe2-4f3f-b53e-4e709179300a.jpg,Airplane,953,1113,1752,1918,160,166
3192,2560,2560,JPEG,RGB,False,1,22291e0b-ebe2-4f3f-b53e-4e709179300a.jpg,Airplane,767,927,1834,2006,160,172
3193,2560,2560,JPEG,RGB,False,1,22291e0b-ebe2-4f3f-b53e-4e709179300a.jpg,Airplane,587,675,1921,2039,88,118
3194,2560,2560,JPEG,RGB,False,1,22291e0b-ebe2-4f3f-b53e-4e709179300a.jpg,Airplane,462,558,1977,2093,96,116
3195,2560,2560,JPEG,RGB,False,1,22291e0b-ebe2-4f3f-b53e-4e709179300a.jpg,Airplane,327,417,2034,2153,90,119
3196,2560,2560,JPEG,RGB,False,1,22291e0b-ebe2-4f3f-b53e-4e709179300a.jpg,Airplane,2375,2447,1499,1593,72,94
3197,2560,2560,JPEG,RGB,False,1,22291e0b-ebe2-4f3f-b53e-4e709179300a.jpg,Airplane,2218,2308,1557,1651,90,94
3198,2560,2560,JPEG,RGB,False,1,22291e0b-ebe2-4f3f-b53e-4e709179300a.jpg,Airplane,2111,2197,1622,1720,86,98
3199,2560,2560,JPEG,RGB,False,1,22291e0b-ebe2-4f3f-b53e-4e709179300a.jpg,Airplane,1984,2069,1642,1755,85,113
3200,2560,2560,JPEG,RGB,False,1,22291e0b-ebe2-4f3f-b53e-4e709179300a.jpg,Airplane,1838,1925,1699,1801,87,102
3201,2560,2560,JPEG,RGB,False,1,22291e0b-ebe2-4f3f-b53e-4e709179300a.jpg,Airplane,1735,1801,1775,1860,66,85
3202,2560,2560,JPEG,RGB,False,1,22291e0b-ebe2-4f3f-b53e-4e709179300a.jpg,Truncated_airplane,2478,2559,1735,1839,81,104
3203,2560,2560,JPEG,RGB,False,1,22291e0b-ebe2-4f3f-b53e-4e709179300a.jpg,Airplane,838,1045,2267,2472,207,205
3204,2560,2560,JPEG,RGB,False,1,eeb978ec-5945-4def-819a-4ea903b17c2d.jpg,Airplane,609,699,398,501,90,103
3205,2560,2560,JPEG,RGB,False,1,eeb978ec-5945-4def-819a-4ea903b17c2d.jpg,Airplane,888,975,396,498,87,102
3206,2560,2560,JPEG,RGB,False,1,eeb978ec-5945-4def-819a-4ea903b17c2d.jpg,Airplane,988,1075,399,498,87,99
3207,2560,2560,JPEG,RGB,False,1,eeb978ec-5945-4def-819a-4ea903b17c2d.jpg,Airplane,1196,1281,401,488,85,87
3208,2560,2560,JPEG,RGB,False,1,eeb978ec-5945-4def-819a-4ea903b17c2d.jpg,Airplane,1685,1771,401,495,86,94
3209,2560,2560,JPEG,RGB,False,1,eeb978ec-5945-4def-819a-4ea903b17c2d.jpg,Airplane,1611,1710,125,214,99,89
3210,2560,2560,JPEG,RGB,False,1,eeb978ec-5945-4def-819a-4ea903b17c2d.jpg,Airplane,1785,1871,663,762,86,99
3211,2560,2560,JPEG,RGB,False,1,eeb978ec-5945-4def-819a-4ea903b17c2d.jpg,Airplane,2098,2184,667,772,86,105
3212,2560,2560,JPEG,RGB,False,1,eeb978ec-5945-4def-819a-4ea903b17c2d.jpg,Airplane,1592,1679,715,793,87,78
3213,2560,2560,JPEG,RGB,False,1,eeb978ec-5945-4def-819a-4ea903b17c2d.jpg,Airplane,1090,1175,673,764,85,91
3214,2560,2560,JPEG,RGB,False,1,eeb978ec-5945-4def-819a-4ea903b17c2d.jpg,Airplane,889,970,673,756,81,83
3215,2560,2560,JPEG,RGB,False,1,eeb978ec-5945-4def-819a-4ea903b17c2d.jpg,Airplane,795,879,672,758,84,86
3216,2560,2560,JPEG,RGB,False,1,eeb978ec-5945-4def-819a-4ea903b17c2d.jpg,Airplane,2331,2422,1269,1372,91,103
3217,2560,2560,JPEG,RGB,False,1,eeb978ec-5945-4def-819a-4ea903b17c2d.jpg,Airplane,2493,2545,1432,1502,52,70
3218,2560,2560,JPEG,RGB,False,1,eeb978ec-5945-4def-819a-4ea903b17c2d.jpg,Airplane,2425,2478,1433,1505,53,72
3219,2560,2560,JPEG,RGB,False,1,eeb978ec-5945-4def-819a-4ea903b17c2d.jpg,Airplane,2259,2318,1444,1516,59,72
3220,2560,2560,JPEG,RGB,False,1,eeb978ec-5945-4def-819a-4ea903b17c2d.jpg,Airplane,2119,2186,1436,1514,67,78
3221,2560,2560,JPEG,RGB,False,1,eeb978ec-5945-4def-819a-4ea903b17c2d.jpg,Airplane,1924,2007,1418,1519,83,101
3222,2560,2560,JPEG,RGB,False,1,eeb978ec-5945-4def-819a-4ea903b17c2d.jpg,Airplane,1801,1887,1424,1522,86,98
3223,2560,2560,JPEG,RGB,False,1,eeb978ec-5945-4def-819a-4ea903b17c2d.jpg,Airplane,1618,1703,1420,1516,85,96
3224,2560,2560,JPEG,RGB,False,1,eeb978ec-5945-4def-819a-4ea903b17c2d.jpg,Airplane,1337,1413,1419,1512,76,93
3225,2560,2560,JPEG,RGB,False,1,eeb978ec-5945-4def-819a-4ea903b17c2d.jpg,Airplane,1199,1275,1426,1514,76,88
3226,2560,2560,JPEG,RGB,False,1,eeb978ec-5945-4def-819a-4ea903b17c2d.jpg,Airplane,1098,1186,1414,1511,88,97
3227,2560,2560,JPEG,RGB,False,1,eeb978ec-5945-4def-819a-4ea903b17c2d.jpg,Airplane,990,1066,1413,1511,76,98
3228,2560,2560,JPEG,RGB,False,1,eeb978ec-5945-4def-819a-4ea903b17c2d.jpg,Airplane,891,969,1418,1516,78,98
3229,2560,2560,JPEG,RGB,False,1,eeb978ec-5945-4def-819a-4ea903b17c2d.jpg,Airplane,791,886,1406,1524,95,118
3230,2560,2560,JPEG,RGB,False,1,eeb978ec-5945-4def-819a-4ea903b17c2d.jpg,Airplane,907,988,1762,1852,81,90
3231,2560,2560,JPEG,RGB,False,1,eeb978ec-5945-4def-819a-4ea903b17c2d.jpg,Airplane,1002,1084,1764,1855,82,91
3232,2560,2560,JPEG,RGB,False,1,eeb978ec-5945-4def-819a-4ea903b17c2d.jpg,Airplane,1127,1266,1732,1861,139,129
3233,2560,2560,JPEG,RGB,False,1,eeb978ec-5945-4def-819a-4ea903b17c2d.jpg,Airplane,1308,1399,1730,1846,91,116
3234,2560,2560,JPEG,RGB,False,1,eeb978ec-5945-4def-819a-4ea903b17c2d.jpg,Airplane,1789,1868,1758,1847,79,89
3235,2560,2560,JPEG,RGB,False,1,eeb978ec-5945-4def-819a-4ea903b17c2d.jpg,Airplane,1892,1984,1925,2058,92,133
3236,2560,2560,JPEG,RGB,False,1,eeb978ec-5945-4def-819a-4ea903b17c2d.jpg,Airplane,2262,2330,1775,1851,68,76
3237,2560,2560,JPEG,RGB,False,1,eeb978ec-5945-4def-819a-4ea903b17c2d.jpg,Airplane,2491,2546,1784,1862,55,78
3238,2560,2560,JPEG,RGB,False,1,eeb978ec-5945-4def-819a-4ea903b17c2d.jpg,Airplane,491,573,1422,1513,82,91
3239,2560,2560,JPEG,RGB,False,1,eeb978ec-5945-4def-819a-4ea903b17c2d.jpg,Airplane,406,483,1413,1508,77,95
3240,2560,2560,JPEG,RGB,False,1,eeb978ec-5945-4def-819a-4ea903b17c2d.jpg,Airplane,391,479,1759,1858,88,99
3241,2560,2560,JPEG,RGB,False,1,eeb978ec-5945-4def-819a-4ea903b17c2d.jpg,Airplane,492,567,1767,1859,75,92
3242,2560,2560,JPEG,RGB,False,1,eeb978ec-5945-4def-819a-4ea903b17c2d.jpg,Airplane,577,662,1760,1854,85,94
3243,2560,2560,JPEG,RGB,False,1,eeb978ec-5945-4def-819a-4ea903b17c2d.jpg,Airplane,675,760,1759,1851,85,92
3244,2560,2560,JPEG,RGB,False,1,eeb978ec-5945-4def-819a-4ea903b17c2d.jpg,Truncated_airplane,1575,1677,2492,2557,102,65
3245,2560,2560,JPEG,RGB,False,1,eeb3f271-15f5-4977-a921-f4636efc6434.jpg,Airplane,624,717,555,642,93,87
3246,2560,2560,JPEG,RGB,False,1,eeb3f271-15f5-4977-a921-f4636efc6434.jpg,Airplane,538,679,663,784,141,121
3247,2560,2560,JPEG,RGB,False,1,eeb3f271-15f5-4977-a921-f4636efc6434.jpg,Airplane,469,611,788,920,142,132
3248,2560,2560,JPEG,RGB,False,1,eeb3f271-15f5-4977-a921-f4636efc6434.jpg,Airplane,906,984,641,710,78,69
3249,2560,2560,JPEG,RGB,False,1,eeb3f271-15f5-4977-a921-f4636efc6434.jpg,Airplane,903,980,730,807,77,77
3250,2560,2560,JPEG,RGB,False,1,eeb3f271-15f5-4977-a921-f4636efc6434.jpg,Airplane,722,879,922,1059,157,137
3251,2560,2560,JPEG,RGB,False,1,eeb3f271-15f5-4977-a921-f4636efc6434.jpg,Airplane,390,547,922,1056,157,134
3252,2560,2560,JPEG,RGB,False,1,eeb3f271-15f5-4977-a921-f4636efc6434.jpg,Airplane,653,786,1079,1199,133,120
3253,2560,2560,JPEG,RGB,False,1,eeb3f271-15f5-4977-a921-f4636efc6434.jpg,Airplane,489,565,1162,1242,76,80
3254,2560,2560,JPEG,RGB,False,1,eeb3f271-15f5-4977-a921-f4636efc6434.jpg,Airplane,911,991,1354,1436,80,82
3255,2560,2560,JPEG,RGB,False,1,eeb3f271-15f5-4977-a921-f4636efc6434.jpg,Airplane,1331,1408,1032,1111,77,79
3256,2560,2560,JPEG,RGB,False,1,eeb3f271-15f5-4977-a921-f4636efc6434.jpg,Airplane,1539,1614,1586,1677,75,91
3257,2560,2560,JPEG,RGB,False,1,eeb3f271-15f5-4977-a921-f4636efc6434.jpg,Airplane,1878,2008,1220,1348,130,128
3258,2560,2560,JPEG,RGB,False,1,eeb3f271-15f5-4977-a921-f4636efc6434.jpg,Airplane,1911,1992,983,1079,81,96
3259,2560,2560,JPEG,RGB,False,1,eeb3f271-15f5-4977-a921-f4636efc6434.jpg,Airplane,2154,2229,535,624,75,89
3260,2560,2560,JPEG,RGB,False,1,eeb3f271-15f5-4977-a921-f4636efc6434.jpg,Airplane,1710,1779,1710,1799,69,89
3261,2560,2560,JPEG,RGB,False,1,eeb3f271-15f5-4977-a921-f4636efc6434.jpg,Airplane,1906,1985,1880,1968,79,88
3262,2560,2560,JPEG,RGB,False,1,eeb3f271-15f5-4977-a921-f4636efc6434.jpg,Airplane,2064,2127,2203,2258,63,55
3263,2560,2560,JPEG,RGB,False,1,eeb3f271-15f5-4977-a921-f4636efc6434.jpg,Airplane,2254,2335,2242,2343,81,101
3264,2560,2560,JPEG,RGB,False,1,eeb3f271-15f5-4977-a921-f4636efc6434.jpg,Airplane,1834,1912,94,173,78,79
3265,2560,2560,JPEG,RGB,False,1,eeb3f271-15f5-4977-a921-f4636efc6434.jpg,Airplane,1929,1987,156,232,58,76
3266,2560,2560,JPEG,RGB,False,1,eeb3f271-15f5-4977-a921-f4636efc6434.jpg,Airplane,2014,2085,197,286,71,89
3267,2560,2560,JPEG,RGB,False,1,eeb3f271-15f5-4977-a921-f4636efc6434.jpg,Airplane,2104,2195,334,413,91,79
3268,2560,2560,JPEG,RGB,False,1,eeb3f271-15f5-4977-a921-f4636efc6434.jpg,Airplane,1714,1792,333,433,78,100
3269,2560,2560,JPEG,RGB,False,1,eeb3f271-15f5-4977-a921-f4636efc6434.jpg,Airplane,1809,1904,373,495,95,122
3270,2560,2560,JPEG,RGB,False,1,eeb3f271-15f5-4977-a921-f4636efc6434.jpg,Airplane,1917,1980,441,521,63,80
3271,2560,2560,JPEG,RGB,False,1,eeb3f271-15f5-4977-a921-f4636efc6434.jpg,Airplane,1818,1901,697,787,83,90
3272,2560,2560,JPEG,RGB,False,1,eeb3f271-15f5-4977-a921-f4636efc6434.jpg,Airplane,1845,1920,804,872,75,68
3273,2560,2560,JPEG,RGB,False,1,eeb3f271-15f5-4977-a921-f4636efc6434.jpg,Airplane,1819,1893,876,960,74,84
3274,2560,2560,JPEG,RGB,False,1,eeb3f271-15f5-4977-a921-f4636efc6434.jpg,Airplane,1751,1815,942,1020,64,78
3275,2560,2560,JPEG,RGB,False,1,eeb3f271-15f5-4977-a921-f4636efc6434.jpg,Airplane,2339,2376,249,286,37,37
3276,2560,2560,JPEG,RGB,False,1,c20b3c21-a6e9-46f7-8536-d4f92574e111.jpg,Truncated_airplane,2491,2558,1590,1712,67,122
3277,2560,2560,JPEG,RGB,False,1,c20b3c21-a6e9-46f7-8536-d4f92574e111.jpg,Airplane,2315,2450,1468,1601,135,133
3278,2560,2560,JPEG,RGB,False,1,c20b3c21-a6e9-46f7-8536-d4f92574e111.jpg,Airplane,2286,2426,988,1122,140,134
3279,2560,2560,JPEG,RGB,False,1,c20b3c21-a6e9-46f7-8536-d4f92574e111.jpg,Airplane,2381,2512,843,976,131,133
3280,2560,2560,JPEG,RGB,False,1,c20b3c21-a6e9-46f7-8536-d4f92574e111.jpg,Truncated_airplane,2461,2559,714,833,98,119
3281,2560,2560,JPEG,RGB,False,1,c20b3c21-a6e9-46f7-8536-d4f92574e111.jpg,Airplane,1594,1731,1106,1242,137,136
3282,2560,2560,JPEG,RGB,False,1,c20b3c21-a6e9-46f7-8536-d4f92574e111.jpg,Airplane,1754,1827,822,883,73,61
3283,2560,2560,JPEG,RGB,False,1,c20b3c21-a6e9-46f7-8536-d4f92574e111.jpg,Airplane,1884,1958,608,669,74,61
3284,2560,2560,JPEG,RGB,False,1,c20b3c21-a6e9-46f7-8536-d4f92574e111.jpg,Airplane,1652,1724,569,632,72,63
3285,2560,2560,JPEG,RGB,False,1,c20b3c21-a6e9-46f7-8536-d4f92574e111.jpg,Airplane,1339,1469,947,1084,130,137
3286,2560,2560,JPEG,RGB,False,1,c20b3c21-a6e9-46f7-8536-d4f92574e111.jpg,Airplane,1259,1300,953,1008,41,55
3287,2560,2560,JPEG,RGB,False,1,c20b3c21-a6e9-46f7-8536-d4f92574e111.jpg,Airplane,1278,1307,910,942,29,32
3288,2560,2560,JPEG,RGB,False,1,c20b3c21-a6e9-46f7-8536-d4f92574e111.jpg,Airplane,1311,1345,876,913,34,37
3289,2560,2560,JPEG,RGB,False,1,c20b3c21-a6e9-46f7-8536-d4f92574e111.jpg,Airplane,1275,1309,864,901,34,37
3290,2560,2560,JPEG,RGB,False,1,c20b3c21-a6e9-46f7-8536-d4f92574e111.jpg,Airplane,1225,1271,832,888,46,56
3291,2560,2560,JPEG,RGB,False,1,c20b3c21-a6e9-46f7-8536-d4f92574e111.jpg,Airplane,1192,1238,883,941,46,58
3292,2560,2560,JPEG,RGB,False,1,c20b3c21-a6e9-46f7-8536-d4f92574e111.jpg,Airplane,1076,1105,715,747,29,32
3293,2560,2560,JPEG,RGB,False,1,c20b3c21-a6e9-46f7-8536-d4f92574e111.jpg,Airplane,1044,1078,739,778,34,39
3294,2560,2560,JPEG,RGB,False,1,c20b3c21-a6e9-46f7-8536-d4f92574e111.jpg,Airplane,1081,1117,739,780,36,41
3295,2560,2560,JPEG,RGB,False,1,c20b3c21-a6e9-46f7-8536-d4f92574e111.jpg,Airplane,1061,1091,789,823,30,34
3296,2560,2560,JPEG,RGB,False,1,c20b3c21-a6e9-46f7-8536-d4f92574e111.jpg,Airplane,1020,1057,777,826,37,49
3297,2560,2560,JPEG,RGB,False,1,c20b3c21-a6e9-46f7-8536-d4f92574e111.jpg,Airplane,930,993,676,752,63,76
3298,2560,2560,JPEG,RGB,False,1,c20b3c21-a6e9-46f7-8536-d4f92574e111.jpg,Airplane,874,926,636,690,52,54
3299,2560,2560,JPEG,RGB,False,1,c20b3c21-a6e9-46f7-8536-d4f92574e111.jpg,Airplane,802,838,638,678,36,40
3300,2560,2560,JPEG,RGB,False,1,c20b3c21-a6e9-46f7-8536-d4f92574e111.jpg,Airplane,765,809,549,605,44,56
3301,2560,2560,JPEG,RGB,False,1,c20b3c21-a6e9-46f7-8536-d4f92574e111.jpg,Airplane,732,766,554,598,34,44
3302,2560,2560,JPEG,RGB,False,1,c20b3c21-a6e9-46f7-8536-d4f92574e111.jpg,Airplane,730,764,515,559,34,44
3303,2560,2560,JPEG,RGB,False,1,c20b3c21-a6e9-46f7-8536-d4f92574e111.jpg,Airplane,698,732,575,613,34,38
3304,2560,2560,JPEG,RGB,False,1,c20b3c21-a6e9-46f7-8536-d4f92574e111.jpg,Airplane,620,682,503,574,62,71
3305,2560,2560,JPEG,RGB,False,1,c20b3c21-a6e9-46f7-8536-d4f92574e111.jpg,Airplane,407,469,356,436,62,80
3306,2560,2560,JPEG,RGB,False,1,c20b3c21-a6e9-46f7-8536-d4f92574e111.jpg,Airplane,255,366,272,409,111,137
3307,2560,2560,JPEG,RGB,False,1,bd4fba16-ec59-4163-a896-db2274b86a8b.jpg,Airplane,10,180,354,537,170,183
3308,2560,2560,JPEG,RGB,False,1,bd4fba16-ec59-4163-a896-db2274b86a8b.jpg,Airplane,237,403,347,536,166,189
3309,2560,2560,JPEG,RGB,False,1,bd4fba16-ec59-4163-a896-db2274b86a8b.jpg,Airplane,552,699,487,631,147,144
3310,2560,2560,JPEG,RGB,False,1,bd4fba16-ec59-4163-a896-db2274b86a8b.jpg,Airplane,283,467,576,737,184,161
3311,2560,2560,JPEG,RGB,False,1,bd4fba16-ec59-4163-a896-db2274b86a8b.jpg,Airplane,270,454,1018,1183,184,165
3312,2560,2560,JPEG,RGB,False,1,bd4fba16-ec59-4163-a896-db2274b86a8b.jpg,Airplane,565,708,1224,1344,143,120
3313,2560,2560,JPEG,RGB,False,1,bd4fba16-ec59-4163-a896-db2274b86a8b.jpg,Airplane,645,813,1049,1200,168,151
3314,2560,2560,JPEG,RGB,False,1,bd4fba16-ec59-4163-a896-db2274b86a8b.jpg,Airplane,725,883,868,1010,158,142
3315,2560,2560,JPEG,RGB,False,1,bd4fba16-ec59-4163-a896-db2274b86a8b.jpg,Airplane,804,973,680,829,169,149
3316,2560,2560,JPEG,RGB,False,1,bd4fba16-ec59-4163-a896-db2274b86a8b.jpg,Airplane,916,1092,513,663,176,150
3317,2560,2560,JPEG,RGB,False,1,bd4fba16-ec59-4163-a896-db2274b86a8b.jpg,Airplane,1295,1480,851,1005,185,154
3318,2560,2560,JPEG,RGB,False,1,bd4fba16-ec59-4163-a896-db2274b86a8b.jpg,Airplane,1480,1666,698,853,186,155
3319,2560,2560,JPEG,RGB,False,1,bd4fba16-ec59-4163-a896-db2274b86a8b.jpg,Airplane,1521,1705,478,637,184,159
3320,2560,2560,JPEG,RGB,False,1,bd4fba16-ec59-4163-a896-db2274b86a8b.jpg,Airplane,1632,1781,297,431,149,134
3321,2560,2560,JPEG,RGB,False,1,bd4fba16-ec59-4163-a896-db2274b86a8b.jpg,Airplane,1858,2025,827,993,167,166
3322,2560,2560,JPEG,RGB,False,1,bd4fba16-ec59-4163-a896-db2274b86a8b.jpg,Airplane,1949,2045,1088,1187,96,99
3323,2560,2560,JPEG,RGB,False,1,bd4fba16-ec59-4163-a896-db2274b86a8b.jpg,Airplane,2071,2166,1104,1219,95,115
3324,2560,2560,JPEG,RGB,False,1,bd4fba16-ec59-4163-a896-db2274b86a8b.jpg,Airplane,2010,2154,1472,1630,144,158
3325,2560,2560,JPEG,RGB,False,1,bd4fba16-ec59-4163-a896-db2274b86a8b.jpg,Airplane,1889,1989,1489,1599,100,110
3326,2560,2560,JPEG,RGB,False,1,bd4fba16-ec59-4163-a896-db2274b86a8b.jpg,Airplane,2225,2396,1487,1651,171,164
3327,2560,2560,JPEG,RGB,False,1,bd4fba16-ec59-4163-a896-db2274b86a8b.jpg,Airplane,1411,1560,1559,1714,149,155
3328,2560,2560,JPEG,RGB,False,1,bd4fba16-ec59-4163-a896-db2274b86a8b.jpg,Airplane,1359,1446,1736,1823,87,87
3329,2560,2560,JPEG,RGB,False,1,bd4fba16-ec59-4163-a896-db2274b86a8b.jpg,Airplane,1166,1329,1752,1914,163,162
3330,2560,2560,JPEG,RGB,False,1,bd4fba16-ec59-4163-a896-db2274b86a8b.jpg,Airplane,862,1032,1728,1890,170,162
3331,2560,2560,JPEG,RGB,False,1,bd4fba16-ec59-4163-a896-db2274b86a8b.jpg,Airplane,835,980,1443,1561,145,118
3332,2560,2560,JPEG,RGB,False,1,bd4fba16-ec59-4163-a896-db2274b86a8b.jpg,Airplane,749,828,2086,2186,79,100
3333,2560,2560,JPEG,RGB,False,1,bd4fba16-ec59-4163-a896-db2274b86a8b.jpg,Airplane,854,989,2119,2275,135,156
3334,2560,2560,JPEG,RGB,False,1,bd4fba16-ec59-4163-a896-db2274b86a8b.jpg,Airplane,1180,1274,2142,2250,94,108
3335,2560,2560,JPEG,RGB,False,1,bd4fba16-ec59-4163-a896-db2274b86a8b.jpg,Airplane,1327,1431,2225,2315,104,90
3336,2560,2560,JPEG,RGB,False,1,bd4fba16-ec59-4163-a896-db2274b86a8b.jpg,Airplane,1402,1506,2333,2439,104,106
3337,2560,2560,JPEG,RGB,False,1,bd4fba16-ec59-4163-a896-db2274b86a8b.jpg,Airplane,1511,1581,2428,2511,70,83
3338,2560,2560,JPEG,RGB,False,1,bd4fba16-ec59-4163-a896-db2274b86a8b.jpg,Airplane,1629,1728,2413,2507,99,94
3339,2560,2560,JPEG,RGB,False,1,bd4fba16-ec59-4163-a896-db2274b86a8b.jpg,Airplane,1750,1845,2425,2532,95,107
3340,2560,2560,JPEG,RGB,False,1,bd4fba16-ec59-4163-a896-db2274b86a8b.jpg,Airplane,1874,1971,2427,2524,97,97
3341,2560,2560,JPEG,RGB,False,1,bd4fba16-ec59-4163-a896-db2274b86a8b.jpg,Airplane,2224,2320,2447,2551,96,104
3342,2560,2560,JPEG,RGB,False,1,bd4fba16-ec59-4163-a896-db2274b86a8b.jpg,Airplane,2111,2194,2439,2543,83,104
3343,2560,2560,JPEG,RGB,False,1,bd4fba16-ec59-4163-a896-db2274b86a8b.jpg,Airplane,1987,2104,2005,2101,117,96
3344,2560,2560,JPEG,RGB,False,1,bd4fba16-ec59-4163-a896-db2274b86a8b.jpg,Airplane,1868,1962,1841,1939,94,98
3345,2560,2560,JPEG,RGB,False,1,bd4fba16-ec59-4163-a896-db2274b86a8b.jpg,Airplane,2264,2348,2185,2280,84,95
3346,2560,2560,JPEG,RGB,False,1,ae2fddcd-a2b4-4f32-b86d-ac2c2b03d77d.jpg,Airplane,1148,1248,847,922,100,75
3347,2560,2560,JPEG,RGB,False,1,ae2fddcd-a2b4-4f32-b86d-ac2c2b03d77d.jpg,Airplane,937,1038,1035,1126,101,91
3348,2560,2560,JPEG,RGB,False,1,ae2fddcd-a2b4-4f32-b86d-ac2c2b03d77d.jpg,Airplane,544,608,926,983,64,57
3349,2560,2560,JPEG,RGB,False,1,ae2fddcd-a2b4-4f32-b86d-ac2c2b03d77d.jpg,Airplane,555,632,1191,1274,77,83
3350,2560,2560,JPEG,RGB,False,1,ae2fddcd-a2b4-4f32-b86d-ac2c2b03d77d.jpg,Airplane,569,630,1449,1513,61,64
3351,2560,2560,JPEG,RGB,False,1,ae2fddcd-a2b4-4f32-b86d-ac2c2b03d77d.jpg,Airplane,1144,1244,1301,1388,100,87
3352,2560,2560,JPEG,RGB,False,1,ae2fddcd-a2b4-4f32-b86d-ac2c2b03d77d.jpg,Airplane,928,1030,1233,1307,102,74
3353,2560,2560,JPEG,RGB,False,1,ae2fddcd-a2b4-4f32-b86d-ac2c2b03d77d.jpg,Airplane,932,1028,1330,1413,96,83
3354,2560,2560,JPEG,RGB,False,1,ae2fddcd-a2b4-4f32-b86d-ac2c2b03d77d.jpg,Airplane,804,873,1350,1447,69,97
3355,2560,2560,JPEG,RGB,False,1,ae2fddcd-a2b4-4f32-b86d-ac2c2b03d77d.jpg,Airplane,1144,1242,1422,1497,98,75
3356,2560,2560,JPEG,RGB,False,1,ae2fddcd-a2b4-4f32-b86d-ac2c2b03d77d.jpg,Airplane,1150,1248,1566,1651,98,85
3357,2560,2560,JPEG,RGB,False,1,ae2fddcd-a2b4-4f32-b86d-ac2c2b03d77d.jpg,Airplane,932,1033,1703,1780,101,77
3358,2560,2560,JPEG,RGB,False,1,ae2fddcd-a2b4-4f32-b86d-ac2c2b03d77d.jpg,Airplane,1141,1251,1757,1844,110,87
3359,2560,2560,JPEG,RGB,False,1,ae2fddcd-a2b4-4f32-b86d-ac2c2b03d77d.jpg,Airplane,1147,1248,1856,1947,101,91
3360,2560,2560,JPEG,RGB,False,1,ae2fddcd-a2b4-4f32-b86d-ac2c2b03d77d.jpg,Airplane,847,948,1812,1887,101,75
3361,2560,2560,JPEG,RGB,False,1,ae2fddcd-a2b4-4f32-b86d-ac2c2b03d77d.jpg,Airplane,528,631,1772,1865,103,93
3362,2560,2560,JPEG,RGB,False,1,ae2fddcd-a2b4-4f32-b86d-ac2c2b03d77d.jpg,Airplane,937,1039,1927,2008,102,81
3363,2560,2560,JPEG,RGB,False,1,ae2fddcd-a2b4-4f32-b86d-ac2c2b03d77d.jpg,Airplane,928,1033,2046,2118,105,72
3364,2560,2560,JPEG,RGB,False,1,ae2fddcd-a2b4-4f32-b86d-ac2c2b03d77d.jpg,Airplane,544,634,2048,2129,90,81
3365,2560,2560,JPEG,RGB,False,1,ae2fddcd-a2b4-4f32-b86d-ac2c2b03d77d.jpg,Airplane,1880,1971,1015,1088,91,73
3366,2560,2560,JPEG,RGB,False,1,ae2fddcd-a2b4-4f32-b86d-ac2c2b03d77d.jpg,Airplane,1774,1871,1119,1193,97,74
3367,2560,2560,JPEG,RGB,False,1,ae2fddcd-a2b4-4f32-b86d-ac2c2b03d77d.jpg,Airplane,1770,1864,1213,1292,94,79
3368,2560,2560,JPEG,RGB,False,1,ae2fddcd-a2b4-4f32-b86d-ac2c2b03d77d.jpg,Airplane,1527,1632,1202,1275,105,73
3369,2560,2560,JPEG,RGB,False,1,ae2fddcd-a2b4-4f32-b86d-ac2c2b03d77d.jpg,Airplane,1535,1618,1377,1456,83,79
3370,2560,2560,JPEG,RGB,False,1,ae2fddcd-a2b4-4f32-b86d-ac2c2b03d77d.jpg,Airplane,1774,1871,1401,1470,97,69
3371,2560,2560,JPEG,RGB,False,1,ae2fddcd-a2b4-4f32-b86d-ac2c2b03d77d.jpg,Airplane,1766,1857,1701,1774,91,73
3372,2560,2560,JPEG,RGB,False,1,ae2fddcd-a2b4-4f32-b86d-ac2c2b03d77d.jpg,Airplane,1537,1646,1695,1775,109,80
3373,2560,2560,JPEG,RGB,False,1,ae2fddcd-a2b4-4f32-b86d-ac2c2b03d77d.jpg,Airplane,1538,1644,1792,1868,106,76
3374,2560,2560,JPEG,RGB,False,1,ae2fddcd-a2b4-4f32-b86d-ac2c2b03d77d.jpg,Airplane,1540,1637,1883,1960,97,77
3375,2560,2560,JPEG,RGB,False,1,ae2fddcd-a2b4-4f32-b86d-ac2c2b03d77d.jpg,Airplane,1543,1643,1979,2052,100,73
3376,2560,2560,JPEG,RGB,False,1,ae2fddcd-a2b4-4f32-b86d-ac2c2b03d77d.jpg,Airplane,1536,1639,2069,2138,103,69
3377,2560,2560,JPEG,RGB,False,1,ae2fddcd-a2b4-4f32-b86d-ac2c2b03d77d.jpg,Airplane,1752,1841,1884,1961,89,77
3378,2560,2560,JPEG,RGB,False,1,ae2fddcd-a2b4-4f32-b86d-ac2c2b03d77d.jpg,Airplane,1762,1866,2066,2140,104,74
3379,2560,2560,JPEG,RGB,False,1,ae2fddcd-a2b4-4f32-b86d-ac2c2b03d77d.jpg,Airplane,2152,2238,947,1013,86,66
3380,2560,2560,JPEG,RGB,False,1,ae2fddcd-a2b4-4f32-b86d-ac2c2b03d77d.jpg,Airplane,2149,2234,1033,1100,85,67
3381,2560,2560,JPEG,RGB,False,1,ae2fddcd-a2b4-4f32-b86d-ac2c2b03d77d.jpg,Airplane,2050,2122,1130,1199,72,69
3382,2560,2560,JPEG,RGB,False,1,ae2fddcd-a2b4-4f32-b86d-ac2c2b03d77d.jpg,Airplane,2152,2236,1648,1734,84,86
3383,2560,2560,JPEG,RGB,False,1,ae2fddcd-a2b4-4f32-b86d-ac2c2b03d77d.jpg,Airplane,2158,2240,1734,1814,82,80
3384,2560,2560,JPEG,RGB,False,1,ae2fddcd-a2b4-4f32-b86d-ac2c2b03d77d.jpg,Airplane,2163,2247,1823,1902,84,79
3385,2560,2560,JPEG,RGB,False,1,ae2fddcd-a2b4-4f32-b86d-ac2c2b03d77d.jpg,Airplane,2155,2239,1983,2069,84,86
3386,2560,2560,JPEG,RGB,False,1,ae2fddcd-a2b4-4f32-b86d-ac2c2b03d77d.jpg,Airplane,535,623,2283,2355,88,72
3387,2560,2560,JPEG,RGB,False,1,ae2fddcd-a2b4-4f32-b86d-ac2c2b03d77d.jpg,Airplane,928,1032,2140,2226,104,86
3388,2560,2560,JPEG,RGB,False,1,ae2fddcd-a2b4-4f32-b86d-ac2c2b03d77d.jpg,Airplane,939,1037,2242,2322,98,80
3389,2560,2560,JPEG,RGB,False,1,ae2fddcd-a2b4-4f32-b86d-ac2c2b03d77d.jpg,Airplane,1159,1248,2050,2128,89,78
3390,2560,2560,JPEG,RGB,False,1,ae2fddcd-a2b4-4f32-b86d-ac2c2b03d77d.jpg,Airplane,1167,1262,2143,2220,95,77
3391,2560,2560,JPEG,RGB,False,1,ae2fddcd-a2b4-4f32-b86d-ac2c2b03d77d.jpg,Airplane,1154,1252,2232,2311,98,79
3392,2560,2560,JPEG,RGB,False,1,ae2fddcd-a2b4-4f32-b86d-ac2c2b03d77d.jpg,Airplane,1535,1634,2159,2229,99,70
3393,2560,2560,JPEG,RGB,False,1,ae2fddcd-a2b4-4f32-b86d-ac2c2b03d77d.jpg,Airplane,1554,1656,2242,2331,102,89
3394,2560,2560,JPEG,RGB,False,1,ae2fddcd-a2b4-4f32-b86d-ac2c2b03d77d.jpg,Airplane,1758,1855,2241,2319,97,78
3395,2560,2560,JPEG,RGB,False,1,ae2fddcd-a2b4-4f32-b86d-ac2c2b03d77d.jpg,Airplane,1950,2037,2439,2536,87,97
3396,2560,2560,JPEG,RGB,False,1,ae2fddcd-a2b4-4f32-b86d-ac2c2b03d77d.jpg,Airplane,2391,2471,941,1004,80,63
3397,2560,2560,JPEG,RGB,False,1,ae2fddcd-a2b4-4f32-b86d-ac2c2b03d77d.jpg,Airplane,2190,2267,2248,2329,77,81
3398,2560,2560,JPEG,RGB,False,1,ae2fddcd-a2b4-4f32-b86d-ac2c2b03d77d.jpg,Airplane,2374,2448,2264,2340,74,76
3399,2560,2560,JPEG,RGB,False,1,ed921ec7-b950-460c-a912-12247d867fea.jpg,Airplane,2291,2391,455,558,100,103
3400,2560,2560,JPEG,RGB,False,1,ed921ec7-b950-460c-a912-12247d867fea.jpg,Airplane,2053,2148,506,616,95,110
3401,2560,2560,JPEG,RGB,False,1,ed921ec7-b950-460c-a912-12247d867fea.jpg,Airplane,975,1062,73,166,87,93
3402,2560,2560,JPEG,RGB,False,1,ed921ec7-b950-460c-a912-12247d867fea.jpg,Airplane,726,857,296,420,131,124
3403,2560,2560,JPEG,RGB,False,1,ed921ec7-b950-460c-a912-12247d867fea.jpg,Airplane,709,769,441,497,60,56
3404,2560,2560,JPEG,RGB,False,1,ed921ec7-b950-460c-a912-12247d867fea.jpg,Airplane,743,815,815,874,72,59
3405,2560,2560,JPEG,RGB,False,1,ed921ec7-b950-460c-a912-12247d867fea.jpg,Airplane,1814,1864,650,701,50,51
3406,2560,2560,JPEG,RGB,False,1,ed921ec7-b950-460c-a912-12247d867fea.jpg,Airplane,1982,2042,784,851,60,67
3407,2560,2560,JPEG,RGB,False,1,ed921ec7-b950-460c-a912-12247d867fea.jpg,Airplane,589,713,1027,1128,124,101
3408,2560,2560,JPEG,RGB,False,1,ed921ec7-b950-460c-a912-12247d867fea.jpg,Airplane,540,665,1139,1241,125,102
3409,2560,2560,JPEG,RGB,False,1,ed921ec7-b950-460c-a912-12247d867fea.jpg,Airplane,535,601,1279,1339,66,60
3410,2560,2560,JPEG,RGB,False,1,ed921ec7-b950-460c-a912-12247d867fea.jpg,Airplane,253,323,1503,1560,70,57
3411,2560,2560,JPEG,RGB,False,1,ed921ec7-b950-460c-a912-12247d867fea.jpg,Airplane,1856,1926,1182,1239,70,57
3412,2560,2560,JPEG,RGB,False,1,ed921ec7-b950-460c-a912-12247d867fea.jpg,Airplane,2082,2145,1107,1162,63,55
3413,2560,2560,JPEG,RGB,False,1,ed921ec7-b950-460c-a912-12247d867fea.jpg,Airplane,2130,2198,1159,1213,68,54
3414,2560,2560,JPEG,RGB,False,1,ed921ec7-b950-460c-a912-12247d867fea.jpg,Airplane,1862,1935,1309,1372,73,63
3415,2560,2560,JPEG,RGB,False,1,ed921ec7-b950-460c-a912-12247d867fea.jpg,Airplane,2211,2309,1343,1456,98,113
3416,2560,2560,JPEG,RGB,False,1,ed921ec7-b950-460c-a912-12247d867fea.jpg,Airplane,1426,1489,1477,1530,63,53
3417,2560,2560,JPEG,RGB,False,1,ed921ec7-b950-460c-a912-12247d867fea.jpg,Airplane,603,693,1610,1718,90,108
3418,2560,2560,JPEG,RGB,False,1,ed921ec7-b950-460c-a912-12247d867fea.jpg,Airplane,419,477,1722,1798,58,76
3419,2560,2560,JPEG,RGB,False,1,ed921ec7-b950-460c-a912-12247d867fea.jpg,Airplane,250,323,1617,1674,73,57
3420,2560,2560,JPEG,RGB,False,1,ed921ec7-b950-460c-a912-12247d867fea.jpg,Airplane,1160,1270,2091,2186,110,95
3421,2560,2560,JPEG,RGB,False,1,ed921ec7-b950-460c-a912-12247d867fea.jpg,Airplane,1491,1600,2185,2276,109,91
3422,2560,2560,JPEG,RGB,False,1,ed921ec7-b950-460c-a912-12247d867fea.jpg,Airplane,1440,1553,2298,2390,113,92
3423,2560,2560,JPEG,RGB,False,1,ed921ec7-b950-460c-a912-12247d867fea.jpg,Airplane,439,508,2048,2108,69,60
3424,2560,2560,JPEG,RGB,False,1,ed921ec7-b950-460c-a912-12247d867fea.jpg,Airplane,2445,2499,49,110,54,61
